Rk,Player,Nation,Pos,Squad,Comp,Age,Born,90s,Tkl,TklW,Def 3rd,Mid 3rd,Att 3rd,Tkl,Att,Tkl%,Past,Blocks,Sh,Pass,Int,Tkl+Int,Clr,Err,Matches,-9999
1,Max Aarons,eng ENG,DF,Norwich City,eng Premier League,21,2000,32.0,64,44,49,15,0,37,55,67.3,18,39,19,20,28,92,96,1,Matches,774cf58b
2,Yunis Abdelhamid,ma MAR,DF,Reims,fr Ligue 1,33,1987,33.1,48,27,34,14,0,16,32,50.0,16,50,25,25,68,116,104,0,Matches,32c2d95f
3,Salis Abdul Samed,gh GHA,MF,Clermont Foot,fr Ligue 1,21,2000,27.4,43,23,25,16,2,20,57,35.1,37,18,1,17,42,85,15,0,Matches,82464ce3
4,Laurent Abergel,fr FRA,MF,Lorient,fr Ligue 1,28,1993,32.8,110,60,44,53,13,71,166,42.8,95,58,1,57,55,165,13,0,Matches,31626657
5,Charles Abi,fr FRA,FW,Saint-Étienne,fr Ligue 1,21,2000,0.5,0,0,0,0,0,0,1,0.0,1,2,0,2,0,0,0,0,Matches,469d3d84
6,Dickson Abiama,ng NGA,FW,Greuther Fürth,de Bundesliga,22,1998,8.1,11,7,4,5,2,2,10,20.0,8,12,1,11,4,15,8,0,Matches,cadd666a
7,Matthis Abline,fr FRA,FW,Rennes,fr Ligue 1,18,2003,1.1,0,0,0,0,0,0,0,,0,2,0,2,0,0,1,0,Matches,0e46fa2f
8,Tammy Abraham,eng ENG,FW,Roma,it Serie A,23,1997,34.3,27,13,7,14,6,9,22,40.9,13,17,3,14,5,32,27,0,Matches,f586779e
9,Luis Abram,pe PER,DF,Granada,es La Liga,25,1996,6.2,6,3,3,3,0,2,4,50.0,2,6,5,1,5,11,37,1,Matches,1f462f95
10,Francesco Acerbi,it ITA,DF,Lazio,it Serie A,33,1988,28.2,25,12,15,9,1,12,19,63.2,7,37,28,9,34,59,92,0,Matches,b96b595c
11,Ragnar Ache,de GER,MFFW,Eint Frankfurt,de Bundesliga,23,1998,2.9,2,0,0,1,1,1,4,25.0,3,3,0,3,0,2,1,0,Matches,dc38e3bc
12,Mohamed Achi,fr FRA,MF,Nantes,fr Ligue 1,19,2002,0.1,0,0,0,0,0,0,0,,0,0,0,0,0,0,0,0,Matches,1e93fc5d
13,Marcos Acuña,ar ARG,DF,Sevilla,es La Liga,29,1991,25.1,50,29,27,14,9,30,47,63.8,17,22,5,17,14,64,25,1,Matches,81442ecb
14,Che Adams,sct SCO,FW,Southampton,eng Premier League,25,1996,22.7,13,6,5,5,3,2,16,12.5,14,18,2,16,8,21,18,0,Matches,f2bf1b0f
15,Tyler Adams,us USA,MF,RB Leipzig,de Bundesliga,22,1999,15.0,23,7,5,16,2,7,25,28.0,18,24,1,23,16,39,19,2,Matches,2b09d998
16,Sargis Adamyan,am ARM,MFFW,Hoffenheim,de Bundesliga,28,1993,3.7,8,6,3,4,1,3,11,27.3,8,4,0,4,1,9,2,0,Matches,22919e97
17,Martin Adeline,fr FRA,MFFW,Reims,fr Ligue 1,17,2003,3.9,15,11,5,8,2,8,16,50.0,8,0,0,0,11,26,6,0,Matches,7587446d
18,Amine Adli,fr FRA,MFFW,Leverkusen,de Bundesliga,21,2000,14.0,27,14,10,14,3,8,15,53.3,7,26,2,24,11,38,12,0,Matches,dcfb17f4
19,Yacine Adli,fr FRA,MFFW,Bordeaux,fr Ligue 1,21,2000,25.1,43,27,22,14,7,19,68,27.9,49,33,3,30,37,80,11,2,Matches,26777636
20,Michel Aebischer,ch SUI,MF,Bologna,it Serie A,24,1997,4.9,14,5,5,8,1,6,11,54.5,5,4,1,3,6,20,3,0,Matches,f9c927de
21,Felix Afena-Gyan,gh GHA,FWMF,Roma,it Serie A,18,2003,7.4,10,3,1,6,3,4,7,57.1,3,4,0,4,3,13,0,0,Matches,0154d290
22,Martin Agirregabiria,es ESP,DFMF,Alavés,es La Liga,25,1996,18.0,34,22,17,11,6,18,37,48.6,19,20,3,17,25,59,38,0,Matches,355c883a
23,Julen Agirrezabala,es ESP,GK,Athletic Club,es La Liga,20,2000,4.0,0,0,0,0,0,0,0,,0,0,0,0,0,0,2,0,Matches,a2c1a8d3
24,Lucien Agoume,fr FRA,MF,Brest,fr Ligue 1,19,2002,20.8,51,31,24,20,7,23,45,51.1,22,29,9,20,52,103,27,1,Matches,8bc8829a
25,Kevin Agudelo,co COL,MFFW,Spezia,it Serie A,22,1998,13.7,44,26,13,26,5,7,20,35.0,13,22,0,22,8,52,6,0,Matches,46fa7204
26,Nayef Aguerd,ma MAR,DF,Rennes,fr Ligue 1,25,1996,30.4,27,18,16,11,0,14,24,58.3,10,24,14,10,24,51,127,1,Matches,288e1e13
27,Sergio Agüero,ar ARG,FW,Barcelona,es La Liga,33,1988,1.7,1,1,0,0,1,0,2,0.0,2,0,0,0,0,1,0,0,Matches,4d034881
28,Ruben Aguilar,fr FRA,DF,Monaco,fr Ligue 1,28,1993,23.8,78,53,39,32,7,43,68,63.2,25,19,4,15,44,122,57,0,Matches,3dd738a1
29,Álvaro Aguirre,es ESP,MF,Rayo Vallecano,es La Liga,21,2000,0.1,0,0,0,0,0,0,0,,0,0,0,0,0,0,0,0,Matches,93b054dc
30,Naouirou Ahamada,fr FRA,MFDF,Stuttgart,de Bundesliga,19,2002,0.7,1,0,1,0,0,1,3,33.3,2,0,0,0,0,1,0,0,Matches,a6c58494
31,Anel Ahmedhodzic,ba BIH,DF,Bordeaux,fr Ligue 1,22,1999,15.0,38,26,27,9,2,20,31,64.5,11,16,8,8,22,60,44,0,Matches,eab957a3
32,Jean-Eudes Aholou,ci CIV,MF,Strasbourg,fr Ligue 1,27,1994,11.2,16,9,4,9,3,5,19,26.3,14,8,1,7,19,35,7,0,Matches,48b28bfd
33,Joseph Aidoo,gh GHA,DF,Celta Vigo,es La Liga,25,1995,29.3,39,26,28,10,1,17,31,54.8,14,23,13,10,38,77,96,3,Matches,18abe173
34,Ola Aina,ng NGA,DF,Torino,it Serie A,24,1996,16.0,27,19,11,10,6,15,23,65.2,8,17,3,14,28,55,30,0,Matches,246d153b
35,Rayan Aït Nouri,fr FRA,DFMF,Wolves,eng Premier League,20,2001,20.3,64,36,46,15,3,22,44,50.0,22,24,2,22,22,86,39,1,Matches,9b398aea
36,Kristoffer Ajer,no NOR,DF,Brentford,eng Premier League,23,1998,22.2,29,18,21,6,2,13,21,61.9,8,19,11,8,26,55,74,0,Matches,a8c0acb7
37,Ludovic Ajorque,re REU,FW,Strasbourg,fr Ligue 1,27,1994,30.4,36,25,5,19,12,7,40,17.5,33,28,3,25,8,44,31,1,Matches,462475ed
38,Manuel Akanji,ch SUI,DF,Dortmund,de Bundesliga,26,1995,25.1,33,23,20,11,2,22,32,68.8,10,26,15,11,35,68,58,0,Matches,89ac64a6
39,Carlos Akapo,gq EQG,DF,Cádiz,es La Liga,28,1993,20.5,43,31,26,15,2,21,37,56.8,16,26,7,19,51,94,61,0,Matches,f2a68b97
40,Marley Aké,fr FRA,FWMF,Juventus,it Serie A,20,2001,0.9,0,0,0,0,0,0,2,0.0,2,0,0,0,1,1,0,0,Matches,414e1f69
41,Nathan Aké,nl NED,DF,Manchester City,eng Premier League,26,1995,10.3,16,9,7,8,1,6,8,75.0,2,7,5,2,8,24,23,0,Matches,eaeca114
42,Ilias Akhomach,es ESP,FW,Barcelona,es La Liga,17,2004,1.4,2,0,0,1,1,0,0,,0,0,0,0,0,2,0,0,Matches,b8bd60fe
43,Maghnes Akliouche,fr FRA,MFFW,Monaco,fr Ligue 1,19,2002,0.6,2,0,0,2,0,0,1,0.0,1,2,0,2,0,2,0,0,Matches,b625b241
44,Paul Akouokou,ci CIV,MF,Betis,es La Liga,23,1997,5.7,14,9,5,7,2,8,12,66.7,4,6,0,6,11,25,6,0,Matches,31f5b89b
45,Jean-Daniel Akpa-Akpro,ci CIV,MF,Lazio,it Serie A,28,1992,3.5,17,10,7,9,1,7,12,58.3,5,4,2,2,2,19,6,0,Matches,fdf4b948
46,Kevin Akpoguma,ng NGA,DFFW,Hoffenheim,de Bundesliga,26,1995,17.0,33,19,16,11,6,16,28,57.1,12,32,2,30,20,53,29,2,Matches,6ec6fde0
47,David Alaba,at AUT,DF,Real Madrid,es La Liga,29,1992,29.4,23,13,15,6,2,9,19,47.4,10,26,15,11,22,45,70,1,Matches,05439de2
48,Sofiane Alakouch,ma MAR,DFMF,Metz,fr Ligue 1,23,1998,1.8,7,4,3,4,0,2,5,40.0,3,4,0,4,1,8,4,0,Matches,5314e067
49,Tomás Alarcón,cl CHI,MF,Cádiz,es La Liga,22,1999,15.8,31,20,17,10,4,10,31,32.3,21,19,7,12,30,61,31,0,Matches,99ea2ddd
50,Lucas Alario,ar ARG,FW,Leverkusen,de Bundesliga,28,1992,7.3,6,5,0,2,4,2,5,40.0,3,5,0,5,1,7,6,0,Matches,834d0be5
51,Jordi Alba,es ESP,DF,Barcelona,es La Liga,32,1989,29.4,47,34,12,26,9,27,47,57.4,20,26,6,20,33,80,41,1,Matches,4601e194
52,Josué Albert,gf GUF,DF,Clermont Foot,fr Ligue 1,29,1992,0.2,0,0,0,0,0,0,0,,0,0,0,0,1,1,2,0,Matches,3d738df0
53,Luis Alberto,es ESP,MF,Lazio,it Serie A,28,1992,26.1,29,17,8,11,10,8,52,15.4,44,32,4,28,13,42,7,0,Matches,5294a83f
54,Raúl Albiol,es ESP,DF,Villarreal,es La Liga,35,1985,27.4,26,15,20,5,1,14,18,77.8,4,24,15,9,21,47,126,1,Matches,4bd414c1
55,Marc Albrighton,eng ENG,MFDF,Leicester City,eng Premier League,31,1989,12.6,31,19,16,9,6,10,47,21.3,37,15,3,12,14,45,20,0,Matches,b827d5b3
56,Paco Alcácer,es ESP,FW,Villarreal,es La Liga,27,1993,8.7,9,3,2,4,3,1,5,20.0,4,7,0,7,6,15,1,0,Matches,a7a9d95a
57,Thiago Alcántara,es ESP,MF,Liverpool,eng Premier League,30,1991,17.0,48,29,14,24,10,10,42,23.8,32,22,2,20,26,74,13,2,Matches,77e84962
58,Rubén Alcaraz,es ESP,MF,Cádiz,es La Liga,30,1991,12.3,41,20,14,24,3,22,45,48.9,23,10,2,8,13,54,14,0,Matches,036bba5f
59,Omar Alderete,py PAR,DF,Valencia,es La Liga,24,1996,26.7,53,34,34,17,2,34,53,64.2,19,30,18,12,35,88,153,0,Matches,bb08bce9
60,Iván Alejo,es ESP,MF,Cádiz,es La Liga,26,1995,11.8,33,15,21,10,2,15,44,34.1,29,12,0,12,8,41,17,0,Matches,3d7e48ce
61,Doğan Alemdar,tr TUR,GK,Rennes,fr Ligue 1,18,2002,12.0,0,0,0,0,0,0,0,,0,0,0,0,0,0,9,1,Matches,9e17ccff
62,Carles Aleñá,es ESP,MF,Getafe,es La Liga,23,1998,25.8,27,19,11,13,3,9,48,18.8,39,21,2,19,15,42,16,0,Matches,6c811eb7
63,Trent Alexander-Arnold,eng ENG,DF,Liverpool,eng Premier League,22,1998,31.7,40,23,19,13,8,27,60,45.0,33,22,4,18,43,83,40,0,Matches,cd1acf9d
64,Mircea Alexandru Tirlea,ro ROU,DF,Alavés,es La Liga,21,2000,0.2,0,0,0,0,0,0,0,,0,0,0,0,0,0,1,0,Matches,683a1d81
65,Mohamed Ali Cho,fr FRA,FW,Angers,fr Ligue 1,17,2004,20.4,10,5,1,4,5,5,17,29.4,12,17,1,16,8,18,0,1,Matches,f8405304
66,Alisson,br BRA,GK,Liverpool,eng Premier League,28,1992,36.0,3,1,3,0,0,3,5,60.0,2,1,0,1,0,3,28,1,Matches,7a2e46a8
67,Allan,br BRA,MF,Everton,eng Premier League,30,1991,24.3,74,44,28,39,7,34,105,32.4,71,40,9,31,23,97,39,1,Matches,cc700722
68,Jim Allevinah,ga GAB,MFFW,Clermont Foot,fr Ligue 1,26,1995,16.5,18,13,8,8,2,5,18,27.8,13,11,0,11,6,24,4,0,Matches,1956b948
69,Dele Alli,eng ENG,MF,Tottenham,eng Premier League,25,1996,7.3,14,8,10,3,1,5,17,29.4,12,22,5,17,6,20,16,0,Matches,cea4ee8f
70,Dele Alli,eng ENG,MFFW,Everton,eng Premier League,25,1996,3.8,7,2,3,4,0,0,4,0.0,4,7,2,5,6,13,10,0,Matches,cea4ee8f
71,Miguel Almirón,py PAR,MFFW,Newcastle Utd,eng Premier League,27,1994,19.1,47,29,23,17,7,11,44,25.0,33,14,1,13,20,67,13,0,Matches,862a1c15
72,Marcos Alonso,es ESP,DF,Chelsea,eng Premier League,30,1990,24.1,41,29,20,12,9,17,36,47.2,19,29,5,24,43,84,53,0,Matches,f4290206
73,Giorgio Altare,it ITA,DF,Cagliari,it Serie A,22,1998,16.3,39,28,18,18,3,21,26,80.8,5,17,5,12,30,69,70,0,Matches,aa5322d5
74,Hugo Álvarez,es ESP,FW,Celta Vigo,es La Liga,18,2003,0.1,1,0,1,0,0,0,0,,0,0,0,0,0,1,1,0,Matches,6f392eb8
75,Yeray Álvarez,es ESP,DF,Athletic Club,es La Liga,26,1995,20.7,24,14,15,8,1,10,18,55.6,8,21,16,5,45,69,97,0,Matches,3ecc11d8
76,Dani Alves,br BRA,DF,Barcelona,es La Liga,38,1983,12.2,30,19,13,13,4,14,26,53.8,12,10,3,7,11,41,10,2,Matches,c9e99e49
77,Steven Alzate,co COL,MF,Brighton,eng Premier League,22,1998,4.5,10,4,4,5,1,4,7,57.1,3,2,1,1,10,20,10,0,Matches,ad1f61f3
78,Ibrahim Amadou,fr FRA,DFMF,Metz,fr Ligue 1,28,1993,9.0,16,8,10,6,0,8,15,53.3,7,4,2,2,14,30,26,0,Matches,9260926b
79,Emmanuel Amankwaa Akurugu,gh GHA,DF,Getafe,es La Liga,19,2001,0.9,0,0,0,0,0,0,2,0.0,2,1,0,1,0,0,0,0,Matches,69c5633e
80,Daniel Amartey,gh GHA,DF,Leicester City,eng Premier League,26,1994,23.6,26,13,19,7,0,19,29,65.5,10,30,22,8,21,47,93,4,Matches,1a4ef233
81,Amath,sn SEN,MFFW,Mallorca,es La Liga,25,1996,9.8,21,11,11,6,4,7,17,41.2,10,12,0,12,7,28,7,0,Matches,f3b1d9a2
82,Jordan Amavi,fr FRA,DF,Nice,fr Ligue 1,27,1994,4.6,16,10,8,7,1,10,17,58.8,7,3,1,2,15,31,7,0,Matches,22721b88
83,Jordan Amavi,fr FRA,DFFW,Marseille,fr Ligue 1,27,1994,1.4,6,5,3,1,2,5,10,50.0,5,1,0,1,1,7,3,0,Matches,22721b88
84,Wisdom Amey,it ITA,DF,Bologna,it Serie A,15,2005,0.8,3,2,1,1,1,2,3,66.7,1,2,0,2,3,6,1,0,Matches,35b4bc62
85,Kelvin Amian,fr FRA,DF,Spezia,it Serie A,23,1998,29.4,66,42,43,18,5,30,41,73.2,11,39,21,18,32,98,75,0,Matches,bcc81786
86,Nadiem Amiri,de GER,MF,Genoa,it Serie A,24,1996,7.6,6,4,2,2,2,2,9,22.2,7,7,0,7,0,6,0,0,Matches,555d5edd
87,Nadiem Amiri,de GER,MF,Leverkusen,de Bundesliga,24,1996,4.1,8,4,3,2,3,4,8,50.0,4,4,2,2,5,13,0,0,Matches,555d5edd
88,Ethan Ampadu,wls WAL,MFDF,Venezia,it Serie A,20,2000,25.4,67,43,37,27,3,24,58,41.4,34,49,19,30,51,118,76,0,Matches,10b9fa99
89,Sofyan Amrabat,ma MAR,MF,Fiorentina,it Serie A,24,1996,10.5,24,13,9,13,2,11,19,57.9,8,25,8,17,5,29,6,1,Matches,5a2cb25d
90,Joachim Andersen,dk DEN,DF,Crystal Palace,eng Premier League,25,1996,32.4,30,23,21,9,0,16,27,59.3,11,29,19,10,37,67,125,3,Matches,e34fc66d
91,Felipe Anderson,br BRA,FW,Lazio,it Serie A,28,1993,32.1,71,45,30,33,8,27,99,27.3,72,65,6,59,20,91,16,0,Matches,9f1893b9
92,Sebastian Andersson,se SWE,FW,Köln,de Bundesliga,30,1991,14.0,11,7,0,3,8,3,9,33.3,6,8,0,8,3,14,14,0,Matches,b4cf5806
93,Florin Andone,ro ROU,FW,Cádiz,es La Liga,28,1993,2.0,1,1,1,0,0,0,1,0.0,1,2,0,2,0,1,1,0,Matches,dc008610
94,Andrés Andrade Cedeño,pa PAN,DF,Arminia,de Bundesliga,22,1998,11.6,27,16,18,8,1,17,35,48.6,18,16,7,9,19,46,44,0,Matches,6ea23758
95,Benjamin André,fr FRA,MF,Lille,fr Ligue 1,30,1990,30.6,123,69,49,65,9,51,113,45.1,62,49,11,38,50,173,56,0,Matches,ef9c1c95
96,Fredrik André Bjørkan,no NOR,DF,Hertha BSC,de Bundesliga,22,1998,3.9,12,10,7,4,1,7,9,77.8,2,6,2,4,6,18,8,0,Matches,3724baa1
97,Robert Andrich,de GER,MF,Leverkusen,de Bundesliga,26,1994,20.2,33,17,18,14,1,14,28,50.0,14,19,7,12,31,64,46,0,Matches,e0b113a7
98,José Ángel,es ESP,DF,Osasuna,es La Liga,31,1989,12.0,20,13,9,9,2,9,14,64.3,5,6,1,5,10,30,21,0,Matches,3024e383
99,Angeliño,es ESP,DF,RB Leipzig,de Bundesliga,24,1997,25.5,28,21,14,13,1,14,30,46.7,16,24,3,21,29,57,40,0,Matches,30941e96
100,Ebenezer Annan,gh GHA,DF,Bologna,it Serie A,18,2002,0.3,1,1,1,0,0,0,0,,0,0,0,0,1,2,1,0,Matches,39aa05a7
101,Cristian Ansaldi,ar ARG,DF,Torino,it Serie A,34,1986,7.7,20,9,11,7,2,10,13,76.9,3,9,1,8,6,26,10,0,Matches,bbafc0c4
102,Janis Antiste,fr FRA,FWMF,Spezia,it Serie A,18,2002,8.8,18,11,6,6,6,5,13,38.5,8,7,1,6,4,22,6,0,Matches,38d9ce53
103,Waldemar Anton,de GER,DF,Stuttgart,de Bundesliga,25,1996,28.8,40,26,22,15,3,19,32,59.4,13,27,16,11,32,72,116,1,Matches,5e66fa06
104,Josep Antoni Gayá,es ESP,DF,Mallorca,es La Liga,21,2000,0.6,0,0,0,0,0,0,0,,0,1,0,1,1,1,3,1,Matches,4a5f2032
105,Michail Antonio,jm JAM,FW,West Ham,eng Premier League,31,1990,33.0,23,17,5,9,9,7,18,38.9,11,19,1,18,3,26,14,0,Matches,ac05f970
106,Christopher Antwi-Adjei,gh GHA,FWMF,Bochum,de Bundesliga,27,1994,12.6,24,18,7,10,7,7,27,25.9,20,13,0,13,1,25,8,0,Matches,0a3f6cde
107,Houssem Aouar,fr FRA,MF,Lyon,fr Ligue 1,23,1998,27.8,46,30,9,25,12,27,54,50.0,27,26,1,25,20,66,5,0,Matches,a5db0bec
108,Adil Aouchiche,fr FRA,MFFW,Saint-Étienne,fr Ligue 1,19,2002,12.0,13,6,5,5,3,5,33,15.2,28,18,1,17,17,30,4,0,Matches,b94b8be1
109,Dennis Appiah,fr FRA,DF,Nantes,fr Ligue 1,29,1992,23.3,55,34,35,18,2,28,48,58.3,20,30,13,17,27,82,74,0,Matches,feb5d3ab
110,Mauro Arambarri,uy URU,MF,Getafe,es La Liga,25,1995,29.6,62,37,19,32,11,20,68,29.4,48,35,5,30,32,94,18,0,Matches,58afe001
111,Mattia Aramu,it ITA,MFFW,Venezia,it Serie A,26,1995,23.3,20,15,5,9,6,8,33,24.2,25,20,2,18,8,28,19,0,Matches,0847b5a5
112,Charles Aránguiz,cl CHI,MF,Leverkusen,de Bundesliga,32,1989,17.5,45,25,18,21,6,22,52,42.3,30,24,4,20,33,78,21,0,Matches,56413b1f
113,Néstor Araujo,mx MEX,DF,Celta Vigo,es La Liga,29,1991,29.1,22,14,17,5,0,9,21,42.9,12,17,10,7,27,49,105,2,Matches,27a013f7
114,Ronald Araújo,uy URU,DF,Barcelona,es La Liga,22,1999,25.2,41,23,29,12,0,21,25,84.0,4,37,20,17,23,64,66,1,Matches,2bef2bca
115,Cameron Archer,eng ENG,FWMF,Aston Villa,eng Premier League,19,2001,0.3,0,0,0,0,0,0,0,,0,0,0,0,0,0,0,0,Matches,05e8ca6d
116,Alphonse Areola,fr FRA,GK,West Ham,eng Premier League,28,1993,1.0,0,0,0,0,0,0,0,,0,0,0,0,0,0,1,0,Matches,2f965a72
117,Jesús Areso,es ESP,DF,Osasuna,es La Liga,22,1999,2.1,3,3,2,1,0,0,2,0.0,2,0,0,0,0,3,2,1,Matches,94e01ec6
118,Matias Arezo,uy URU,FWMF,Granada,es La Liga,18,2002,1.8,5,3,2,1,2,4,9,44.4,5,1,0,1,1,6,1,0,Matches,484ebdb0
119,Santiago Arias,co COL,DF,Granada,es La Liga,29,1992,4.9,12,5,8,3,1,4,9,44.4,5,8,4,4,5,17,10,0,Matches,fdd60087
120,Adam Armstrong,eng ENG,FW,Southampton,eng Premier League,24,1997,15.7,10,4,2,2,6,0,6,0.0,6,13,1,12,3,13,6,0,Matches,68c720b5
121,Stuart Armstrong,sct SCO,MF,Southampton,eng Premier League,29,1992,16.4,27,19,15,6,6,9,23,39.1,14,10,1,9,8,35,15,0,Matches,97333cf5
122,Marko Arnautović,at AUT,FW,Bologna,it Serie A,32,1989,29.9,17,9,1,11,5,7,30,23.3,23,13,2,11,7,24,17,0,Matches,00459419
123,Maximilian Arnold,de GER,MF,Wolfsburg,de Bundesliga,27,1994,33.3,37,20,19,16,2,20,50,40.0,30,43,15,28,37,74,55,0,Matches,86e119e0
124,Kepa Arrizabalaga,es ESP,GK,Chelsea,eng Premier League,26,1994,4.0,0,0,0,0,0,0,0,,0,0,0,0,0,0,4,0,Matches,28d596a0
125,Tolgay Arslan,de GER,MF,Udinese,it Serie A,30,1990,18.4,35,20,15,16,4,19,50,38.0,31,17,4,13,13,48,23,1,Matches,963a328b
126,Arthur,br BRA,FW,Fiorentina,it Serie A,23,1998,8.3,9,5,2,5,2,4,7,57.1,3,4,1,3,1,10,8,0,Matches,a820e429
127,Santiago Arzamendia,py PAR,MF,Cádiz,es La Liga,23,1998,5.2,14,6,6,5,3,6,13,46.2,7,6,0,6,4,18,7,0,Matches,759d8dd7
128,Takuma Asano,jp JPN,FWMF,Bochum,de Bundesliga,26,1994,17.9,11,6,3,6,2,5,19,26.3,14,14,1,13,7,18,7,0,Matches,13ddc856
129,Santiago Ascacíbar,ar ARG,MF,Hertha BSC,de Bundesliga,24,1997,26.4,93,54,50,37,6,38,89,42.7,51,31,6,25,41,134,42,0,Matches,e26fcca3
130,Sergio Asenjo,es ESP,GK,Villarreal,es La Liga,32,1989,6.0,0,0,0,0,0,0,1,0.0,1,0,0,0,1,1,6,0,Matches,9f0ea33f
131,Alejandro Asensio,es ESP,MF,Rayo Vallecano,es La Liga,20,2000,0.1,0,0,0,0,0,0,0,,0,0,0,0,0,0,0,0,Matches,b4c23f36
132,Marco Asensio,es ESP,FWMF,Real Madrid,es La Liga,25,1996,19.2,12,8,6,4,2,4,18,22.2,14,8,1,7,12,24,6,1,Matches,45af8a54
133,Harrison Ashby,sct SCO,DF,West Ham,eng Premier League,19,2001,0.1,0,0,0,0,0,0,0,,0,1,0,1,1,1,1,0,Matches,b391383a
134,Kristoffer Askildsen,no NOR,MF,Sampdoria,it Serie A,20,2001,8.4,18,6,7,11,0,9,19,47.4,10,14,7,7,15,33,15,0,Matches,a69cc629
135,Fisnik Asllani,xk KVX,MFFW,Hoffenheim,de Bundesliga,18,2002,0.1,0,0,0,0,0,0,1,0.0,1,0,0,0,0,0,0,0,Matches,35f67a30
136,Kristjan Asllani,al ALB,MF,Empoli,it Serie A,19,2002,15.0,18,9,9,8,1,11,29,37.9,18,16,7,9,19,37,15,1,Matches,0fdcef0e
137,Iago Aspas,es ESP,FW,Celta Vigo,es La Liga,33,1987,34.3,14,7,1,5,8,4,24,16.7,20,23,2,21,11,25,19,0,Matches,7dcf86f6
138,Lorenz Assignon,tg TOG,DF,Rennes,fr Ligue 1,21,2000,6.8,15,10,11,3,1,5,9,55.6,4,3,1,2,11,26,19,0,Matches,b026bbf6
139,Simon Asta,de GER,DF,Greuther Fürth,de Bundesliga,20,2001,8.7,13,6,4,5,4,4,8,50.0,4,14,2,12,8,21,16,0,Matches,dfc85b89
140,Youcef Atal,dz ALG,DF,Nice,fr Ligue 1,25,1996,12.7,29,19,17,10,2,14,25,56.0,11,13,2,11,32,61,21,0,Matches,6a827d8e
141,Pierre-Emerick Aubameyang,ga GAB,FW,Arsenal,eng Premier League,32,1989,11.5,11,5,6,4,1,3,10,30.0,7,12,1,11,0,11,4,0,Matches,d5dd5f1f
142,Pierre-Emerick Aubameyang,ga GAB,FW,Barcelona,es La Liga,32,1989,12.0,2,2,0,1,1,0,5,0.0,5,9,1,8,2,4,4,0,Matches,d5dd5f1f
143,Emil Audero,it ITA,GK,Sampdoria,it Serie A,24,1997,28.4,3,1,3,0,0,3,5,60.0,2,0,0,0,2,5,17,2,Matches,649b01d8
144,Tommaso Augello,it ITA,DF,Sampdoria,it Serie A,26,1994,26.6,36,20,22,8,6,17,29,58.6,12,19,4,15,29,65,68,1,Matches,3cd3b384
145,Jean-Kévin Augustin,fr FRA,FWMF,Nantes,fr Ligue 1,24,1997,0.9,1,0,0,0,1,0,3,0.0,3,1,0,1,0,1,0,0,Matches,97bfa797
146,Ludwig Augustinsson,se SWE,DF,Sevilla,es La Liga,27,1994,8.8,18,14,11,3,4,8,13,61.5,5,10,3,7,5,23,21,0,Matches,9fec8860
147,Serge Aurier,ci CIV,DF,Villarreal,es La Liga,28,1992,11.2,14,9,11,2,1,4,7,57.1,3,14,7,7,11,25,25,0,Matches,5c2b4f07
148,Ezequiel Ávila,ar ARG,FWMF,Osasuna,es La Liga,27,1994,20.8,17,7,6,7,4,7,21,33.3,14,14,2,12,13,30,15,1,Matches,253a06b9
149,Taiwo Awoniyi,ng NGA,FW,Union Berlin,de Bundesliga,23,1997,24.2,11,7,3,6,2,1,9,11.1,8,11,2,9,2,13,29,0,Matches,e5478b87
150,Ramzi Aya,it ITA,DF,Salernitana,it Serie A,30,1990,1.5,1,1,1,0,0,1,1,100.0,0,0,0,0,0,1,4,0,Matches,6a1f66a7
151,Jordan Ayew,gh GHA,FWMF,Crystal Palace,eng Premier League,29,1991,22.4,47,30,20,20,7,17,31,54.8,14,33,3,30,15,62,15,0,Matches,da052c14
152,Kaan Ayhan,tr TUR,DF,Sassuolo,it Serie A,26,1994,15.0,20,12,14,6,0,7,15,46.7,8,20,14,6,13,33,57,0,Matches,2200181e
153,Luke Ayling,eng ENG,DF,Leeds United,eng Premier League,29,1991,25.2,74,42,46,23,5,51,97,52.6,46,46,25,21,28,102,52,1,Matches,420d7c7d
154,Karim Azamoum,fr FRA,DF,Troyes,fr Ligue 1,31,1990,4.3,6,5,4,2,0,3,5,60.0,2,4,2,2,1,7,10,0,Matches,eaf71a5e
155,Sardar Azmoun,ir IRN,FWMF,Leverkusen,de Bundesliga,26,1995,4.0,3,1,0,2,1,0,5,0.0,5,2,0,2,0,3,8,0,Matches,10549b49
156,César Azpilicueta,es ESP,DF,Chelsea,eng Premier League,31,1989,23.0,51,28,18,27,6,16,35,45.7,19,32,9,23,23,74,65,1,Matches,53cad200
157,Iddrisu Baba,gh GHA,MF,Mallorca,es La Liga,25,1996,21.5,57,30,31,23,3,25,43,58.1,18,19,5,14,24,81,34,1,Matches,bfd381b3
158,Carlos Bacca,co COL,FW,Granada,es La Liga,34,1986,5.7,4,4,2,0,2,0,3,0.0,3,5,0,5,1,5,5,0,Matches,09a9e921
159,Daniel Bachmann,at AUT,GK,Watford,eng Premier League,27,1994,12.0,0,0,0,0,0,0,0,,0,0,0,0,1,1,5,0,Matches,1c0eea98
160,Loïc Bade,fr FRA,DF,Rennes,fr Ligue 1,21,2000,10.9,6,5,4,2,0,3,5,60.0,2,12,10,2,12,18,48,0,Matches,114bbdee
161,Milan Badelj,hr CRO,MF,Genoa,it Serie A,32,1989,31.6,64,37,25,30,9,34,80,42.5,46,39,7,32,85,149,43,0,Matches,e8c930bb
162,Édgar Badía,es ESP,GK,Elche,es La Liga,29,1992,24.0,0,0,0,0,0,0,0,,0,0,0,0,0,0,16,2,Matches,e4346678
163,Benoît Badiashile,fr FRA,DF,Monaco,fr Ligue 1,20,2001,20.4,36,19,21,15,0,14,23,60.9,9,18,12,6,28,64,68,1,Matches,06df8256
164,Youssouph Badji,sn SEN,FWMF,Brest,fr Ligue 1,19,2001,1.5,1,0,0,1,0,0,1,0.0,1,0,0,0,0,1,0,0,Matches,6a2b9aee
165,Miguel Baeza,es ESP,DF,Celta Vigo,es La Liga,21,2000,0.0,0,0,0,0,0,0,0,,0,0,0,0,0,0,0,0,Matches,a98f3cbf
166,Nicola Bagnolini,it ITA,GK,Bologna,it Serie A,17,2004,0.0,0,0,0,0,0,0,0,,0,0,0,0,0,0,0,0,Matches,ad263695
167,Issa Bah,lu LUX,FW,Venezia,it Serie A,19,2002,0.1,0,0,0,0,0,0,0,,0,0,0,0,0,0,0,0,Matches,956a78ea
168,Stéphane Bahoken,cm CMR,FW,Angers,fr Ligue 1,29,1992,12.2,13,8,2,7,4,1,9,11.1,8,15,0,15,3,16,3,0,Matches,5046b7d4
169,Leon Bailey,jm JAM,MFFW,Aston Villa,eng Premier League,23,1997,8.5,17,11,6,8,3,6,13,46.2,7,10,1,9,1,18,2,0,Matches,3a233281
170,Eric Bailly,ci CIV,DF,Manchester Utd,eng Premier League,27,1994,2.4,5,4,4,0,1,3,4,75.0,1,4,2,2,3,8,11,0,Matches,a1232f4e
171,Dénys Bain,fr FRA,DF,Brest,fr Ligue 1,28,1993,2.0,3,3,1,2,0,1,1,100.0,0,3,1,2,3,6,5,0,Matches,5065d67d
172,Stefan Bajic,fr FRA,GK,Saint-Étienne,fr Ligue 1,19,2001,5.7,0,0,0,0,0,0,0,,0,0,0,0,0,0,4,0,Matches,be13e5a8
173,Nedim Bajrami,al ALB,MFFW,Empoli,it Serie A,22,1999,22.8,21,14,5,13,3,4,14,28.6,10,11,0,11,3,24,8,0,Matches,f42d6c13
174,Cédric Bakambu,cd COD,FWMF,Marseille,fr Ligue 1,30,1991,4.0,2,0,1,0,1,0,3,0.0,3,2,0,2,0,2,1,0,Matches,0af4dcf0
175,Abdoulaye Bakayoko,fr FRA,DF,Saint-Étienne,fr Ligue 1,18,2002,3.4,15,9,12,3,0,8,12,66.7,4,5,4,1,11,26,16,0,Matches,ee95585f
176,Tiemoué Bakayoko,fr FRA,MF,Milan,it Serie A,26,1994,5.6,19,13,9,7,3,5,16,31.3,11,8,1,7,9,28,10,2,Matches,59bf127b
177,Mitchel Bakker,nl NED,DF,Leverkusen,de Bundesliga,21,2000,20.2,33,22,16,12,5,20,34,58.8,14,13,2,11,23,56,42,3,Matches,a8567629
178,Ridle Baku,de GER,DFMF,Wolfsburg,de Bundesliga,23,1998,27.2,62,37,30,24,8,25,65,38.5,40,43,1,42,21,83,52,1,Matches,442b56fa
179,Dilane Bakwa,fr FRA,MFFW,Bordeaux,fr Ligue 1,18,2002,0.5,1,1,0,1,0,1,2,50.0,1,0,0,0,0,1,1,0,Matches,2b5a35e5
180,Tommaso Baldanzi,it ITA,FW,Empoli,it Serie A,18,2003,0.2,0,0,0,0,0,0,0,,0,1,0,1,0,0,0,0,Matches,102e2599
181,Alejandro Balde,es ESP,DFFW,Barcelona,es La Liga,17,2003,2.1,2,1,1,0,1,0,0,,0,2,2,0,1,3,1,0,Matches,5ccc9672
182,Ibrahima Baldé,fr FRA,FWMF,Lens,fr Ligue 1,18,2003,0.6,0,0,0,0,0,0,0,,0,0,0,0,0,0,0,0,Matches,a30cb0d4
183,Keita Baldé,sn SEN,FWMF,Cagliari,it Serie A,26,1995,13.7,8,4,1,5,2,1,10,10.0,9,6,0,6,4,12,6,0,Matches,509a4ccb
184,Gareth Bale,wls WAL,FW,Real Madrid,es La Liga,32,1989,3.1,2,1,1,0,1,1,4,25.0,3,2,0,2,2,4,1,0,Matches,a58bb1e1
185,Mikel Balenziaga,es ESP,DF,Athletic Club,es La Liga,33,1988,22.5,33,24,15,15,3,25,43,58.1,18,27,4,23,21,54,79,0,Matches,1fe67e86
186,Leonardo Balerdi,ar ARG,DF,Marseille,fr Ligue 1,22,1999,10.6,9,6,9,0,0,5,14,35.7,9,11,4,7,19,28,30,0,Matches,7c3ed041
187,Iván Balliu,al ALB,DF,Rayo Vallecano,es La Liga,29,1992,35.0,45,22,25,11,9,19,31,61.3,12,24,5,19,39,84,64,0,Matches,cee88597
188,Fodé Ballo-Touré,sn SEN,DF,Milan,it Serie A,24,1997,5.0,18,14,5,13,0,4,9,44.4,5,6,2,4,3,21,5,0,Matches,f449640d
189,Folarin Balogun,eng ENG,FW,Arsenal,eng Premier League,20,2001,0.8,1,1,0,0,1,0,0,,0,1,0,1,0,1,1,0,Matches,31822f8c
190,Abdoulaye Bamba,ci CIV,DFFW,Angers,fr Ligue 1,31,1990,5.1,6,5,6,0,0,4,11,36.4,7,5,1,4,9,15,13,0,Matches,7fecbcdb
191,Jonathan Bamba,fr FRA,MF,Lille,fr Ligue 1,25,1996,27.0,30,12,13,9,8,13,36,36.1,23,24,1,23,21,51,10,0,Matches,b2bd0f6c
192,Patrick Bamford,eng ENG,FW,Leeds United,eng Premier League,27,1993,6.2,1,0,0,1,0,0,3,0.0,3,8,2,6,2,3,8,0,Matches,93feac6e
193,Filippo Bandinelli,it ITA,MF,Empoli,it Serie A,26,1995,21.7,33,20,10,17,6,15,31,48.4,16,22,5,17,10,43,37,2,Matches,d44360be
194,Mattia Bani,it ITA,DF,Genoa,it Serie A,27,1993,13.5,23,13,17,6,0,14,18,77.8,4,19,11,8,20,43,76,0,Matches,0821331c
195,Simon Banza,fr FRA,FW,Lens,fr Ligue 1,24,1996,1.4,2,1,0,0,2,0,2,0.0,2,1,0,1,1,3,2,0,Matches,be47b750
196,Shandon Baptiste,gd GRN,MF,Brentford,eng Premier League,23,1998,10.1,14,4,9,4,1,6,15,40.0,9,10,0,10,11,25,12,0,Matches,2886c9b5
197,Antonín Barák,cz CZE,MFFW,Hellas Verona,it Serie A,26,1994,26.0,18,8,9,8,1,5,17,29.4,12,32,5,27,6,24,26,0,Matches,01efac19
198,Barbero,es ESP,FWMF,Osasuna,es La Liga,22,1998,0.2,0,0,0,0,0,0,0,,0,0,0,0,0,0,1,0,Matches,981c1863
199,Danilo Barbosa,br BRA,DF,Nice,fr Ligue 1,25,1996,1.0,0,0,0,0,0,0,0,,0,1,1,0,2,2,10,0,Matches,0557ff4f
200,Barcia,es ESP,DF,Granada,es La Liga,20,2000,0.8,0,0,0,0,0,0,0,,0,1,1,0,1,1,0,1,Matches,0c717ae6
201,Bradley Barcola,fr FRA,MFFW,Lyon,fr Ligue 1,18,2002,2.9,7,4,2,3,2,1,8,12.5,7,7,1,6,2,9,1,1,Matches,a0d55a09
202,Melvin Bard,fr FRA,DF,Nice,fr Ligue 1,20,2000,28.8,59,37,38,17,4,41,63,65.1,22,33,10,23,51,110,56,0,Matches,1ddbc7ca
203,Enis Bardhi,mk MKD,MFFW,Levante,es La Liga,26,1995,18.9,29,12,12,14,3,12,35,34.3,23,13,2,11,10,39,7,0,Matches,cac2537b
204,Francesco Bardi,it ITA,GK,Bologna,it Serie A,29,1992,2.0,0,0,0,0,0,0,0,,0,0,0,0,0,0,0,0,Matches,0acda699
205,Keidi Bare,al ALB,MF,Espanyol,es La Liga,23,1997,16.5,27,17,14,12,1,11,31,35.5,20,20,10,10,15,42,26,1,Matches,03049c8c
206,Nicolò Barella,it ITA,MF,Inter,it Serie A,24,1997,32.4,63,42,17,35,11,29,55,52.7,26,26,2,24,21,84,8,2,Matches,6928979a
207,Kike Barja,es ESP,MFFW,Osasuna,es La Liga,24,1997,9.6,15,11,4,7,4,8,22,36.4,14,10,1,9,9,24,4,0,Matches,aad53e64
208,Ross Barkley,eng ENG,MFFW,Chelsea,eng Premier League,27,1993,2.0,0,0,0,0,0,0,1,0.0,1,1,0,1,1,1,0,0,Matches,3a24769f
209,Aymen Barkok,ma MAR,MFDF,Eint Frankfurt,de Bundesliga,23,1998,1.8,6,2,2,3,1,2,7,28.6,5,4,1,3,5,11,6,0,Matches,a2a85828
210,Ashley Barnes,eng ENG,FW,Burnley,eng Premier League,31,1989,9.0,11,2,2,7,2,2,9,22.2,7,8,1,7,2,13,5,0,Matches,2691c772
211,Harvey Barnes,eng ENG,MFFW,Leicester City,eng Premier League,23,1997,23.3,31,16,9,11,11,7,23,30.4,16,24,1,23,5,36,7,0,Matches,3ea50f67
212,Antonio Barragán,es ESP,DF,Elche,es La Liga,34,1987,11.3,21,14,13,7,1,11,17,64.7,6,5,3,2,17,38,34,0,Matches,487d9b09
213,Leandro Barreiro Martins,lu LUX,MF,Mainz 05,de Bundesliga,21,2000,19.9,63,32,23,27,13,29,50,58.0,21,23,6,17,32,95,23,0,Matches,00242b75
214,Ander Barrenetxea,es ESP,MFFW,Real Sociedad,es La Liga,19,2001,6.1,15,10,9,6,0,8,18,44.4,10,7,0,7,2,17,2,0,Matches,200e89e1
215,Jacob Barrett Laursen,dk DEN,DF,Arminia,de Bundesliga,26,1994,18.1,16,12,10,6,0,8,21,38.1,13,19,7,12,28,44,43,0,Matches,c0d3bd23
216,Musa Barrow,gm GAM,FWMF,Bologna,it Serie A,22,1998,23.7,12,4,4,4,4,6,20,30.0,14,20,1,19,6,18,8,0,Matches,e5bf73f3
217,Abdourahmane Barry,fr FRA,DF,Greuther Fürth,de Bundesliga,21,2000,2.3,6,4,3,3,0,5,7,71.4,2,5,2,3,4,10,1,0,Matches,8df328f4
218,Marc Bartra,es ESP,DF,Betis,es La Liga,30,1991,22.1,39,14,18,17,4,19,35,54.3,16,39,22,17,33,72,105,1,Matches,b742cc0d
219,Daniele Baselli,it ITA,MFFW,Torino,it Serie A,29,1992,1.7,3,3,2,0,1,2,6,33.3,4,0,0,0,1,4,2,0,Matches,ea06dd97
220,Daniele Baselli,it ITA,MF,Cagliari,it Serie A,29,1992,3.2,6,5,3,1,2,1,5,20.0,4,2,0,2,2,8,5,0,Matches,ea06dd97
221,Toma Bašić,hr CRO,MF,Lazio,it Serie A,24,1996,10.9,12,8,3,9,0,5,17,29.4,12,13,4,9,4,16,21,0,Matches,80556f08
222,Toma Bašić,hr CRO,MF,Bordeaux,fr Ligue 1,24,1996,2.3,2,2,1,0,1,0,4,0.0,4,4,1,3,2,4,0,0,Matches,80556f08
223,Amine Bassi,fr FRA,MFFW,Metz,fr Ligue 1,23,1997,2.0,6,3,2,3,1,1,3,33.3,2,5,0,5,0,6,0,0,Matches,ced1d98f
224,Álvaro Bastida,es ESP,MF,Cádiz,es La Liga,17,2004,2.2,7,4,2,4,1,4,5,80.0,1,1,0,1,3,10,1,0,Matches,42a028c5
225,Alessandro Bastoni,it ITA,DF,Inter,it Serie A,22,1999,25.7,44,25,28,13,3,17,34,50.0,17,22,12,10,35,79,59,1,Matches,75b86fb3
226,Simone Bastoni,it ITA,MFDF,Spezia,it Serie A,24,1996,25.4,52,34,28,17,7,21,65,32.3,44,38,11,27,30,82,31,0,Matches,1ac232b8
227,Lewis Bate,eng ENG,MF,Leeds United,eng Premier League,18,2002,1.6,1,0,0,0,1,0,8,0.0,8,1,0,1,1,2,1,0,Matches,cd4256d3
228,Rodrigo Battaglia,ar ARG,MF,Mallorca,es La Liga,30,1991,13.1,32,16,13,19,0,15,30,50.0,15,21,10,11,10,42,36,0,Matches,d637fc22
229,Maximilian Bauer,de GER,DF,Greuther Fürth,de Bundesliga,21,2000,18.8,28,15,17,10,1,11,28,39.3,17,24,14,10,29,57,99,0,Matches,44a20f0c
230,Oliver Baumann,de GER,GK,Hoffenheim,de Bundesliga,31,1990,33.0,0,0,0,0,0,0,3,0.0,3,0,0,0,0,0,19,1,Matches,47064058
231,Timo Baumgartl,de GER,DF,Union Berlin,de Bundesliga,25,1996,24.1,59,28,34,21,4,31,47,66.0,16,27,11,16,37,96,58,0,Matches,bd7d2e6d
232,Julian Baumgartlinger,at AUT,MFFW,Leverkusen,de Bundesliga,33,1988,1.0,3,1,2,1,0,1,2,50.0,1,1,0,1,2,5,0,0,Matches,69374ff5
233,Christoph Baumgartner,at AUT,MF,Hoffenheim,de Bundesliga,21,1999,21.0,28,15,14,7,7,13,32,40.6,19,24,3,21,8,36,16,0,Matches,437f2b00
234,Jon Bautista,es ESP,MF,Real Sociedad,es La Liga,26,1995,0.5,3,0,0,3,0,0,1,0.0,1,1,0,1,1,4,1,0,Matches,debc6b55
235,Paul Baysse,fr FRA,MFDF,Bordeaux,fr Ligue 1,33,1988,0.1,1,1,0,1,0,0,0,,0,0,0,0,0,1,1,0,Matches,2515040a
236,Noah Joel Sarenren Bazee,ng NGA,MF,Augsburg,de Bundesliga,24,1996,2.7,5,2,2,2,1,3,4,75.0,1,8,2,6,1,6,4,0,Matches,fbbc8e15
237,Bebé,cv CPV,MFFW,Rayo Vallecano,es La Liga,31,1990,9.6,6,5,1,3,2,4,16,25.0,12,18,0,18,3,9,6,0,Matches,d8712bf9
238,Ihlas Bebou,tg TOG,FWDF,Hoffenheim,de Bundesliga,27,1994,23.2,22,14,5,12,5,7,21,33.3,14,20,3,17,12,34,25,0,Matches,a53b661f
239,Rodrigo Becão,br BRA,DF,Udinese,it Serie A,25,1996,34.8,81,46,49,30,2,34,60,56.7,26,45,20,25,42,123,89,3,Matches,19e4eab9
240,Mads Bech Sørensen,dk DEN,DF,Brentford,eng Premier League,22,1999,9.3,8,7,6,2,0,6,7,85.7,1,9,6,3,6,14,25,0,Matches,30db8574
241,Sheraldo Becker,sr SUR,FWMF,Union Berlin,de Bundesliga,26,1995,19.5,9,6,3,4,2,6,18,33.3,12,11,0,11,2,11,4,0,Matches,8eb55dbb
242,Jan Bednarek,pl POL,DF,Southampton,eng Premier League,25,1996,29.2,32,15,18,13,1,19,33,57.6,14,48,27,21,72,104,141,0,Matches,4115ce4e
243,Donny van de Beek,nl NED,MF,Manchester Utd,eng Premier League,24,1997,0.8,6,4,4,1,1,1,2,50.0,1,5,1,4,2,8,1,0,Matches,50dc94ce
244,Donny van de Beek,nl NED,MF,Everton,eng Premier League,24,1997,5.4,15,7,8,6,1,6,13,46.2,7,6,2,4,6,21,4,0,Matches,50dc94ce
245,Asmir Begović,ba BIH,GK,Everton,eng Premier League,34,1987,3.0,0,0,0,0,0,0,0,,0,0,0,0,0,0,3,0,Matches,7b4de647
246,Valon Behrami,ch SUI,MF,Genoa,it Serie A,36,1985,3.5,3,1,0,2,1,0,7,0.0,7,4,1,3,1,4,4,0,Matches,d3d758d8
247,Kevin Behrens,de GER,FW,Union Berlin,de Bundesliga,30,1991,5.5,3,2,1,1,1,0,4,0.0,4,3,0,3,3,6,7,0,Matches,30ae134d
248,Youcef Belaïli,dz ALG,MFFW,Brest,fr Ligue 1,29,1992,9.2,2,1,0,0,2,2,9,22.2,7,5,1,4,7,9,4,0,Matches,1a248246
249,Vid Belec,si SVN,GK,Salernitana,it Serie A,31,1990,21.5,0,0,0,0,0,0,0,,0,0,0,0,0,0,9,1,Matches,4f8ce0e1
250,Ishak Belfodil,dz ALG,FW,Hertha BSC,de Bundesliga,29,1992,18.2,9,6,4,4,1,4,8,50.0,4,9,1,8,5,14,16,0,Matches,ff182fdc
251,Haris Belkebla,dz ALG,MF,Brest,fr Ligue 1,27,1994,25.7,46,23,21,21,4,18,39,46.2,21,26,6,20,48,94,30,1,Matches,2b1bed19
252,Stefan Bell,de GER,DF,Mainz 05,de Bundesliga,29,1991,31.8,54,23,37,16,1,30,63,47.6,33,26,15,11,41,95,112,1,Matches,857a5abe
253,Armel Bella Kotchap,de GER,DF,Bochum,de Bundesliga,19,2001,19.6,34,20,25,9,0,18,28,64.3,10,23,17,6,43,77,88,2,Matches,a39d11bc
254,Raoul Bellanova,it ITA,DF,Cagliari,it Serie A,21,2000,27.7,29,15,14,12,3,6,27,22.2,21,39,8,31,21,50,51,0,Matches,e3756e72
255,Karim Bellarabi,de GER,MFDF,Leverkusen,de Bundesliga,31,1990,7.6,9,4,4,4,1,3,13,23.1,10,5,0,5,9,18,4,0,Matches,bee0bab1
256,Jean-Ricner Bellegarde,fr FRA,MF,Strasbourg,fr Ligue 1,23,1998,25.9,51,32,21,21,9,17,41,41.5,24,29,4,25,27,78,19,0,Matches,10f0fdd3
257,Héctor Bellerín,es ESP,DF,Betis,es La Liga,26,1995,22.0,52,32,29,20,3,31,44,70.5,13,11,2,9,23,75,57,1,Matches,f874dd44
258,Jude Bellingham,eng ENG,MF,Dortmund,de Bundesliga,18,2003,31.0,52,34,15,31,6,21,53,39.6,32,50,4,46,42,94,32,0,Matches,57d88cf9
259,George Bello,us USA,DF,Arminia,de Bundesliga,19,2002,4.8,7,7,7,0,0,4,4,100.0,0,5,4,1,6,13,11,0,Matches,aca0a525
260,Jeanöel Belocian,fr FRA,DF,Rennes,fr Ligue 1,16,2005,0.1,0,0,0,0,0,0,0,,0,0,0,0,0,0,0,0,Matches,c678ddd7
261,Andrea Belotti,it ITA,FW,Torino,it Serie A,27,1993,15.2,7,3,2,2,3,3,12,25.0,9,12,4,8,2,9,9,0,Matches,d705ba44
262,Fran Beltrán,es ESP,MF,Celta Vigo,es La Liga,22,1999,28.9,56,41,27,23,6,28,68,41.2,40,29,5,24,32,88,39,0,Matches,ed5c5fa3
263,Hatem Ben Arfa,fr FRA,FWMF,Lille,fr Ligue 1,34,1987,3.5,4,2,2,1,1,2,4,50.0,2,3,0,3,0,4,1,0,Matches,74dc806c
264,Salim Ben Seghir,fr FRA,MF,Marseille,fr Ligue 1,18,2003,0.0,0,0,0,0,0,0,0,,0,0,0,0,0,0,0,0,Matches,1f6298f2
265,Wissam Ben Yedder,fr FRA,FW,Monaco,fr Ligue 1,30,1990,28.1,18,8,1,11,6,6,15,40.0,9,12,1,11,0,18,1,0,Matches,942b4f90
266,Marco Benassi,it ITA,DFMF,Fiorentina,it Serie A,26,1994,1.8,1,0,1,0,0,1,2,50.0,1,3,0,3,3,4,3,0,Matches,0000acda
267,Marco Benassi,it ITA,MF,Empoli,it Serie A,26,1994,4.2,6,3,3,2,1,1,10,10.0,9,4,0,4,3,9,6,0,Matches,0000acda
268,Darío Benedetto,ar ARG,FWMF,Elche,es La Liga,31,1990,6.6,5,1,2,2,1,3,6,50.0,3,4,0,4,1,6,1,0,Matches,bef0a7ac
269,Darío Benedetto,ar ARG,FWMF,Marseille,fr Ligue 1,31,1990,0.6,0,0,0,0,0,0,0,,0,2,0,2,0,0,0,0,Matches,bef0a7ac
270,László Bénes,sk SVK,MF,M'Gladbach,de Bundesliga,23,1997,2.7,5,3,1,3,1,1,6,16.7,5,5,2,3,2,7,5,0,Matches,fe888e39
271,Walter Benítez,ar ARG,GK,Nice,fr Ligue 1,28,1993,37.0,0,0,0,0,0,0,2,0.0,2,1,0,1,0,0,12,2,Matches,8a2248b4
272,Iker Benito,es ESP,MFFW,Osasuna,es La Liga,18,2002,1.3,2,1,1,0,1,0,1,0.0,1,2,0,2,0,2,2,0,Matches,50cbc806
273,Loris Benito,ch SUI,DF,Bordeaux,fr Ligue 1,29,1992,0.7,0,0,0,0,0,0,0,,0,0,0,0,1,1,3,1,Matches,f5b6fb78
274,Pedro Benito,es ESP,FW,Cádiz,es La Liga,21,2000,0.3,0,0,0,0,0,0,1,0.0,1,0,0,0,0,0,0,0,Matches,a7416105
275,Filip Benković,hr CRO,DFFW,Udinese,it Serie A,24,1997,0.1,0,0,0,0,0,0,0,,0,0,0,0,0,0,0,0,Matches,305a3820
276,Ismaël Bennacer,dz ALG,MF,Milan,it Serie A,23,1997,16.9,44,30,22,15,7,21,50,42.0,29,20,4,16,25,69,15,0,Matches,db092d3b
277,Keanan Bennetts,eng ENG,MFFW,M'Gladbach,de Bundesliga,22,1999,0.6,2,0,1,1,0,1,1,100.0,0,1,0,1,0,2,0,0,Matches,f4c7c708
278,Saïd Benrahma,dz ALG,MF,West Ham,eng Premier League,25,1995,24.1,28,17,16,9,3,15,38,39.5,23,17,1,16,9,37,8,0,Matches,5a04fd92
279,Ramy Bensebaini,dz ALG,DF,M'Gladbach,de Bundesliga,26,1995,22.4,44,29,25,16,3,29,46,63.0,17,33,7,26,39,83,87,2,Matches,378825c7
280,Nabil Bentaleb,dz ALG,MF,Angers,fr Ligue 1,26,1994,16.8,42,24,15,20,7,16,29,55.2,13,24,9,15,28,70,13,0,Matches,3189f61a
281,Rodrigo Bentancur,uy URU,MF,Tottenham,eng Premier League,24,1997,15.1,36,18,14,14,8,16,32,50.0,16,24,9,15,20,56,35,0,Matches,3b8674e6
282,Rodrigo Bentancur,uy URU,MF,Juventus,it Serie A,24,1997,12.8,32,18,11,18,3,7,20,35.0,13,15,2,13,26,58,15,1,Matches,3b8674e6
283,Christian Benteke,be BEL,FW,Crystal Palace,eng Premier League,30,1990,12.7,3,2,1,2,0,2,6,33.3,4,7,3,4,2,5,33,0,Matches,ab070c55
284,Karim Benzema,fr FRA,FW,Real Madrid,es La Liga,33,1987,28.8,11,9,5,3,3,2,9,22.2,7,10,0,10,4,15,13,0,Matches,70d74ece
285,Alessandro Berardi,it ITA,GK,Hellas Verona,it Serie A,30,1991,1.0,0,0,0,0,0,0,0,,0,0,0,0,0,0,0,0,Matches,ec1f737d
286,Domenico Berardi,it ITA,MFFW,Sassuolo,it Serie A,26,1994,31.3,32,19,9,16,7,15,57,26.3,42,39,2,37,31,63,23,0,Matches,53a0e358
287,Yuri Berchiche,es ESP,DF,Athletic Club,es La Liga,31,1990,11.3,25,11,10,11,4,7,14,50.0,7,19,6,13,13,38,25,0,Matches,b6e50615
288,Álex Berenguer,es ESP,MF,Athletic Club,es La Liga,26,1995,24.1,45,26,23,14,8,11,51,21.6,40,40,2,38,16,61,20,0,Matches,dc1c2fce
289,Bartosz Bereszyński,pl POL,DF,Sampdoria,it Serie A,29,1992,32.7,64,38,34,25,5,37,80,46.3,43,38,12,26,42,106,73,1,Matches,61b3978f
290,Jóhann Berg Guðmundsson,is ISL,MF,Burnley,eng Premier League,30,1990,12.2,16,6,7,7,2,5,20,25.0,15,11,2,9,12,28,22,0,Matches,f72293fc
291,Patrick Berg,no NOR,MF,Lens,fr Ligue 1,23,1997,3.4,14,6,6,8,0,0,4,0.0,4,2,1,1,4,18,3,0,Matches,e4114f5d
292,Mitchell van Bergen,nl NED,FWMF,Reims,fr Ligue 1,21,1999,10.9,8,5,7,0,1,6,15,40.0,9,9,0,9,4,12,7,0,Matches,0b2c9aec
293,Steven Bergwijn,nl NED,FWMF,Tottenham,eng Premier League,23,1997,6.3,3,2,2,1,0,1,10,10.0,9,3,0,3,1,4,8,0,Matches,a29b1131
294,Etrit Berisha,al ALB,GK,Torino,it Serie A,32,1989,10.0,0,0,0,0,0,0,0,,0,0,0,0,0,0,4,0,Matches,ee833569
295,Valon Berisha,xk KVX,MFFW,Reims,fr Ligue 1,28,1993,5.1,10,7,2,5,3,2,10,20.0,8,9,0,9,4,14,3,0,Matches,d5575935
296,Federico Bernardeschi,it ITA,MFFW,Juventus,it Serie A,27,1994,16.4,16,10,7,4,5,6,13,46.2,7,12,4,8,5,21,15,0,Matches,ee93c1a9
297,Paul Bernardoni,fr FRA,GK,Angers,fr Ligue 1,24,1997,13.0,3,2,3,0,0,3,4,75.0,1,0,0,0,0,3,8,1,Matches,28dabd43
298,Paul Bernardoni,fr FRA,GK,Saint-Étienne,fr Ligue 1,24,1997,19.0,0,0,0,0,0,0,0,,0,0,0,0,0,0,14,2,Matches,28dabd43
299,Juan Bernat,es ESP,DFMF,Paris S-G,fr Ligue 1,28,1993,10.6,24,14,10,10,4,13,18,72.2,5,8,0,8,8,32,16,0,Matches,433dc9a2
300,Dimitry Bertaud,fr FRA,GK,Montpellier,fr Ligue 1,23,1998,9.3,0,0,0,0,0,0,1,0.0,1,0,0,0,0,0,5,1,Matches,380a15e2
301,Jason Berthomier,fr FRA,MF,Clermont Foot,fr Ligue 1,31,1990,19.2,29,14,5,17,7,12,34,35.3,22,14,2,12,8,37,4,1,Matches,03e91055
302,Nicolò Bertola,it ITA,MFDF,Spezia,it Serie A,18,2003,0.4,3,2,3,0,0,3,4,75.0,1,0,0,0,3,6,1,0,Matches,04b40c58
303,Ryan Bertrand,eng ENG,DF,Leicester City,eng Premier League,31,1989,3.7,8,5,3,4,1,2,5,40.0,3,8,3,5,1,9,7,0,Matches,01226327
304,Daniel Bessa,it ITA,MF,Hellas Verona,it Serie A,28,1993,8.5,7,2,3,3,1,4,15,26.7,11,13,3,10,5,12,11,0,Matches,88895312
305,Beto,gw GNB,FW,Udinese,it Serie A,23,1998,24.1,21,6,2,14,5,9,19,47.4,10,16,1,15,5,26,25,1,Matches,ed5c0319
306,Louis Beyer,de GER,DF,M'Gladbach,de Bundesliga,21,2000,15.4,47,27,32,14,1,24,44,54.5,20,20,7,13,15,62,55,2,Matches,9af1f9ff
307,Bartosz Bialek,pl POL,FWDF,Wolfsburg,de Bundesliga,19,2001,2.0,0,0,0,0,0,0,1,0.0,1,1,0,1,0,0,2,0,Matches,763b8b37
308,Giulian Biancone,fr FRA,DFMF,Troyes,fr Ligue 1,21,2000,25.5,70,42,44,22,4,40,69,58.0,29,23,8,15,53,123,71,1,Matches,de40e38c
309,Ermin Bičakčić,ba BIH,DF,Hoffenheim,de Bundesliga,31,1990,0.1,0,0,0,0,0,0,0,,0,0,0,0,0,0,0,0,Matches,7aac47fe
310,Mads Bidstrup,dk DEN,MF,Brentford,eng Premier League,20,2001,0.5,1,0,0,1,0,0,3,0.0,3,0,0,0,1,2,2,0,Matches,407db0d5
311,Pedro Bigas,es ESP,DF,Elche,es La Liga,30,1990,17.2,24,10,16,8,0,9,20,45.0,11,21,16,5,18,42,77,1,Matches,697295b1
312,El Bilal Touré,ml MLI,FW,Reims,fr Ligue 1,19,2001,13.3,13,6,4,6,3,2,7,28.6,5,10,3,7,6,19,19,0,Matches,47c609d5
313,Jean-Claude Billong,cm CMR,DF,Clermont Foot,fr Ligue 1,27,1993,10.9,17,8,14,1,2,8,11,72.7,3,9,1,8,10,27,35,0,Matches,a3e1d20d
314,Luis Binks,eng ENG,DF,Bologna,it Serie A,19,2001,7.2,8,4,7,1,0,4,6,66.7,2,6,5,1,17,25,33,1,Matches,36e88fbc
315,Cristiano Biraghi,it ITA,DF,Fiorentina,it Serie A,28,1992,35.0,37,24,17,15,5,22,53,41.5,31,28,10,18,19,56,31,1,Matches,9e1577aa
316,Davide Biraschi,it ITA,DF,Genoa,it Serie A,27,1994,10.3,31,16,19,9,3,17,24,70.8,7,16,9,7,16,47,26,0,Matches,64cd167d
317,Tom Bischof,de GER,MF,Hoffenheim,de Bundesliga,16,2005,0.2,0,0,0,0,0,0,0,,0,1,0,1,0,0,1,0,Matches,07d3bfec
318,Yves Bissouma,ml MLI,MF,Brighton,eng Premier League,24,1996,23.5,76,49,35,37,4,21,37,56.8,16,33,3,30,50,126,49,0,Matches,6c203af0
319,Nathan Bitu Mazala,fr FRA,DF,Paris S-G,fr Ligue 1,18,2002,0.1,0,0,0,0,0,0,0,,0,1,0,1,0,0,0,0,Matches,0f697e02
320,Marco Bizot,nl NED,GK,Brest,fr Ligue 1,30,1991,38.0,3,1,3,0,0,3,5,60.0,2,1,0,1,0,3,24,1,Matches,3d214e5f
321,Bjarki Bjarkason,is ISL,MF,Venezia,it Serie A,21,2000,0.0,0,0,0,0,0,0,0,,0,0,0,0,0,0,0,0,Matches,f1d25de7
322,Blanco,es ESP,MF,Real Madrid,es La Liga,21,2000,0.3,2,0,1,1,0,0,0,,0,1,1,0,1,3,0,0,Matches,506daeac
323,Ludovic Blas,fr FRA,MFFW,Nantes,fr Ligue 1,23,1997,32.9,33,18,7,20,6,15,43,34.9,28,33,3,30,31,64,6,1,Matches,6191093d
324,Danny Blum,de GER,FWMF,Bochum,de Bundesliga,30,1991,3.8,2,1,0,0,2,0,2,0.0,2,4,0,4,2,4,1,0,Matches,eb61713c
325,Myron Boadu,nl NED,FW,Monaco,fr Ligue 1,20,2001,10.7,9,7,2,3,4,1,5,20.0,4,6,0,6,2,11,1,0,Matches,5b479568
326,Jérôme Boateng,de GER,DF,Lyon,fr Ligue 1,32,1988,18.0,20,15,11,9,0,9,17,52.9,8,20,10,10,20,40,73,0,Matches,2db2fd7b
327,Kevin-Prince Boateng,gh GHA,MFFW,Hertha BSC,de Bundesliga,34,1987,7.7,6,5,1,4,1,3,9,33.3,6,7,2,5,6,12,11,0,Matches,f4ec4fd0
328,Antonin Bobichon,fr FRA,MFFW,Angers,fr Ligue 1,25,1995,0.4,1,0,0,1,0,0,0,,0,0,0,0,1,2,0,0,Matches,7d937aa1
329,Herbert Bockhorn,de GER,DF,Bochum,de Bundesliga,26,1995,9.4,24,14,14,7,3,13,21,61.9,8,10,1,9,14,38,18,0,Matches,5ad8c360
330,Jean-Paul Boëtius,nl NED,MF,Mainz 05,de Bundesliga,27,1994,20.0,40,23,18,17,5,22,53,41.5,31,41,3,38,25,65,11,0,Matches,635f2732
331,Jeremie Boga,ci CIV,MFFW,Atalanta,it Serie A,24,1997,8.5,7,3,0,4,3,4,6,66.7,2,6,0,6,1,8,3,1,Matches,fe012aca
332,Jeremie Boga,ci CIV,MFFW,Sassuolo,it Serie A,24,1997,7.4,7,4,1,2,4,2,3,66.7,1,3,0,3,2,9,1,1,Matches,fe012aca
333,Luka Bogdan,hr CRO,DF,Salernitana,it Serie A,25,1996,4.4,6,3,6,0,0,4,8,50.0,4,3,2,1,6,12,21,0,Matches,cb678320
334,Emil Bohinen,no NOR,MF,Salernitana,it Serie A,22,1999,7.8,15,9,4,9,2,10,20,50.0,10,17,3,14,12,27,14,0,Matches,c83c203f
335,Quentin Boisgard,fr FRA,MFFW,Lorient,fr Ligue 1,24,1997,10.6,19,11,6,10,3,8,17,47.1,9,15,0,15,6,25,5,0,Matches,f6496133
336,Charles Boli,fr FRA,MFDF,Lens,fr Ligue 1,22,1998,0.4,2,1,0,2,0,0,0,,0,0,0,0,0,2,0,0,Matches,bbdd999a
337,Willy Boly,ci CIV,DF,Wolves,eng Premier League,30,1991,10.0,25,19,18,7,0,8,15,53.3,7,14,6,8,14,39,35,0,Matches,a4ac4b8f
338,Giacomo Bonaventura,it ITA,MF,Fiorentina,it Serie A,31,1989,25.2,33,17,12,16,5,21,46,45.7,25,20,2,18,14,47,9,1,Matches,d995ed27
339,Federico Bonazzoli,it ITA,FWMF,Salernitana,it Serie A,24,1997,20.7,24,12,9,8,7,6,25,24.0,19,17,1,16,6,30,7,0,Matches,bf57eaab
340,Tarsis Bonga,de GER,MFFW,Bochum,de Bundesliga,24,1997,0.2,0,0,0,0,0,0,0,,0,0,0,0,0,0,0,0,Matches,6ebbc28a
341,Kevin Bonifazi,it ITA,DF,Bologna,it Serie A,25,1996,13.4,25,16,16,7,2,13,14,92.9,1,22,7,15,16,41,35,0,Matches,fb77bfef
342,Solomon Bonnah,nl NED,DF,RB Leipzig,de Bundesliga,17,2003,0.1,0,0,0,0,0,0,0,,0,1,0,1,1,1,0,0,Matches,dd7b6eb8
343,Leonardo Bonucci,it ITA,DF,Juventus,it Serie A,34,1987,22.3,14,5,4,10,0,8,13,61.5,5,22,17,5,26,40,82,0,Matches,52ec54d0
344,Sebastiaan Bornauw,be BEL,DF,Wolfsburg,de Bundesliga,22,1999,22.3,30,19,23,5,2,16,25,64.0,9,29,8,21,42,72,97,1,Matches,01834aa0
345,Rafael Borré,co COL,FWMF,Eint Frankfurt,de Bundesliga,25,1995,26.4,31,22,4,13,14,7,33,21.2,26,24,4,20,5,36,9,0,Matches,c68da769
346,Sven Botman,nl NED,DF,Lille,fr Ligue 1,21,2000,25.0,24,11,13,11,0,12,18,66.7,6,32,21,11,26,50,116,0,Matches,ccce7025
347,Denis Bouanga,ga GAB,FWMF,Saint-Étienne,fr Ligue 1,26,1994,27.1,46,25,14,13,19,22,63,34.9,41,30,0,30,8,54,34,1,Matches,0b0cbe5b
348,Hicham Boudaoui,dz ALG,MF,Nice,fr Ligue 1,21,1999,18.0,31,18,15,10,6,13,36,36.1,23,17,4,13,18,49,15,0,Matches,f9d5908e
349,Ryad Boudebouz,dz ALG,MFFW,Saint-Étienne,fr Ligue 1,31,1990,25.0,27,15,11,12,4,12,29,41.4,17,17,2,15,10,37,5,0,Matches,1001ae82
350,Sofiane Boufal,ma MAR,FWMF,Angers,fr Ligue 1,27,1993,25.9,44,29,19,16,9,18,38,47.4,20,19,2,17,7,51,1,0,Matches,b0c71810
351,Farid Boulaya,dz ALG,MFFW,Metz,fr Ligue 1,28,1993,17.0,18,10,7,9,2,14,38,36.8,24,8,2,6,12,30,5,0,Matches,a0791826
352,Yassine Bounou,ma MAR,GK,Sevilla,es La Liga,30,1991,31.0,0,0,0,0,0,0,0,,0,0,0,0,0,0,11,1,Matches,f6798fc3
353,Ismaëlben Boura,fr FRA,DF,Lens,fr Ligue 1,20,2000,1.1,2,2,1,1,0,0,0,,0,1,1,0,2,4,5,0,Matches,62e02107
354,Mehdi Bourabia,ma MAR,MF,Spezia,it Serie A,29,1991,3.1,5,1,2,3,0,3,11,27.3,8,7,6,1,3,8,10,0,Matches,0d077b88
355,Benjamin Bourigeaud,fr FRA,MFFW,Rennes,fr Ligue 1,27,1994,35.5,46,24,16,18,12,24,67,35.8,43,33,3,30,30,76,44,0,Matches,20e73fac
356,Redwan Bourles,fr FRA,MFFW,Lorient,fr Ligue 1,18,2003,0.2,0,0,0,0,0,0,0,,0,0,0,0,0,0,0,0,Matches,5c7895a0
357,Edoardo Bove,it ITA,MFDF,Roma,it Serie A,19,2002,0.8,1,1,1,0,0,0,2,0.0,2,1,0,1,1,2,0,0,Matches,ae94a6c5
358,Jarrod Bowen,eng ENG,MF,West Ham,eng Premier League,24,1996,33.1,36,20,20,11,5,17,44,38.6,27,29,2,27,21,57,14,0,Matches,79c84d1c
359,Dedryck Boyata,be BEL,DF,Hertha BSC,de Bundesliga,30,1990,21.1,15,13,11,3,1,8,11,72.7,3,17,13,4,17,32,134,1,Matches,7c473e12
360,Lucas Boyé,ar ARG,FW,Elche,es La Liga,25,1996,19.0,27,13,5,15,7,9,24,37.5,15,24,1,23,2,29,23,0,Matches,d49f3e6b
361,Domagoj Bradarić,hr CRO,DF,Lille,fr Ligue 1,21,1999,4.6,11,9,8,2,1,7,12,58.3,5,5,2,3,10,21,7,1,Matches,8bbe2df5
362,Bilal Brahimi,dz ALG,MF,Nice,fr Ligue 1,21,2000,4.2,1,1,0,1,0,0,2,0.0,2,1,0,1,2,3,1,0,Matches,02bcaf8e
363,Bilal Brahimi,dz ALG,FW,Angers,fr Ligue 1,21,2000,3.8,1,1,0,1,0,0,3,0.0,3,0,0,0,1,2,1,0,Matches,02bcaf8e
364,Martin Braithwaite,dk DEN,FW,Barcelona,es La Liga,30,1991,2.6,1,1,0,0,1,0,0,,0,2,0,2,1,2,1,0,Matches,fd771f95
365,Julian Brandt,de GER,MF,Dortmund,de Bundesliga,25,1996,23.1,37,19,13,20,4,17,54,31.5,37,19,2,17,24,61,14,1,Matches,a167537f
366,Jarrad Branthwaite,eng ENG,DF,Everton,eng Premier League,19,2002,4.3,4,1,3,1,0,3,8,37.5,5,3,2,1,1,5,20,0,Matches,c1949191
367,Darko Brašanac,rs SRB,MF,Osasuna,es La Liga,29,1992,26.7,35,22,19,14,2,14,40,35.0,26,25,8,17,25,60,15,0,Matches,4accb7e0
368,Lilian Brassier,fr FRA,DF,Brest,fr Ligue 1,21,1999,25.1,40,24,23,13,4,10,21,47.6,11,31,21,10,32,72,86,0,Matches,5b146df3
369,Claudio Bravo,cl CHI,GK,Betis,es La Liga,38,1983,16.2,0,0,0,0,0,0,0,,0,0,0,0,0,0,6,2,Matches,10072610
370,Iker Bravo,es ESP,FWMF,Leverkusen,de Bundesliga,16,2005,0.1,1,1,0,1,0,0,0,,0,0,0,0,0,1,0,0,Matches,db8c8860
371,Fabian Bredlow,de GER,GK,Stuttgart,de Bundesliga,26,1995,4.0,0,0,0,0,0,0,0,,0,0,0,0,0,0,1,0,Matches,d28339cb
372,Josip Brekalo,hr CRO,MF,Torino,it Serie A,23,1998,25.4,9,5,5,1,3,3,21,14.3,18,16,1,15,4,13,7,1,Matches,d4a2533d
373,Josip Brekalo,hr CRO,MF,Wolfsburg,de Bundesliga,23,1998,0.2,0,0,0,0,0,0,0,,0,0,0,0,0,0,0,0,Matches,d4a2533d
374,Gleison Bremer,br BRA,DF,Torino,it Serie A,24,1997,32.1,49,24,27,22,0,18,28,64.3,10,54,23,31,105,154,137,0,Matches,5fd5ed86
375,Jimmy Briand,fr FRA,FWMF,Bordeaux,fr Ligue 1,35,1985,2.5,2,0,2,0,0,0,2,0.0,2,0,0,0,1,3,2,0,Matches,f83c8d6c
376,Yan Brice Eteki,cm CMR,MF,Granada,es La Liga,23,1997,3.8,6,3,3,2,1,3,7,42.9,4,7,3,4,4,10,6,1,Matches,3d688b46
377,Brian Brobbey,nl NED,FWMF,RB Leipzig,de Bundesliga,19,2002,1.5,1,0,0,1,0,1,1,100.0,0,1,0,1,0,1,0,0,Matches,4c184730
378,Armando Broja,al ALB,FW,Southampton,eng Premier League,19,2001,21.9,12,5,2,7,3,2,9,22.2,7,17,1,16,3,15,11,0,Matches,97220da2
379,Dylan Bronn,tn TUN,DF,Metz,fr Ligue 1,26,1995,28.3,47,29,33,13,1,20,31,64.5,11,32,19,13,40,87,78,1,Matches,edd81e2a
380,John Brooks,us USA,DF,Wolfsburg,de Bundesliga,28,1993,29.1,47,25,25,18,4,36,60,60.0,24,33,19,14,41,88,125,1,Matches,e27da244
381,Daniel Brosinski,de GER,DF,Mainz 05,de Bundesliga,33,1988,4.3,2,1,1,1,0,1,1,100.0,0,6,0,6,3,5,9,0,Matches,a7813ac4
382,Josh Brownhill,eng ENG,MF,Burnley,eng Premier League,25,1995,32.8,73,37,25,42,6,21,53,39.6,32,37,12,25,68,141,42,1,Matches,47369df8
383,Marcelo Brozović,hr CRO,MF,Inter,it Serie A,28,1992,32.6,77,45,34,35,8,34,68,50.0,34,28,10,18,37,114,36,2,Matches,33b8d077
384,Cédric Brunner,ch SUI,DF,Arminia,de Bundesliga,27,1994,24.3,51,35,29,20,2,25,49,51.0,24,27,10,17,43,94,84,0,Matches,f0a37d36
385,Lewis Brunt,eng ENG,MF,Leicester City,eng Premier League,20,2000,0.3,0,0,0,0,0,0,0,,0,1,0,1,0,0,0,0,Matches,a2081c6b
386,Jacob Bruun Larsen,dk DEN,MFFW,Hoffenheim,de Bundesliga,22,1998,9.0,2,1,1,1,0,0,5,0.0,5,14,3,11,5,7,5,2,Matches,4e204552
387,Bryan,es ESP,MFDF,Tottenham,eng Premier League,20,2001,1.0,3,0,1,0,2,1,2,50.0,1,2,0,2,0,3,0,0,Matches,7b5ab7f2
388,Bryan,es ESP,MFFW,Valencia,es La Liga,20,2001,8.4,13,8,6,3,4,2,13,15.4,11,13,0,13,1,14,4,0,Matches,7b5ab7f2
389,Ante Budimir,hr CRO,FW,Osasuna,es La Liga,30,1991,19.3,24,10,3,15,6,6,19,31.6,13,22,4,18,3,27,16,0,Matches,8f3565b3
390,Emi Buendía,ar ARG,MFFW,Aston Villa,eng Premier League,24,1996,21.1,38,18,16,13,9,21,51,41.2,30,21,3,18,9,47,11,0,Matches,66b76d44
391,Osman Bukari,gh GHA,MFFW,Nantes,fr Ligue 1,22,1998,11.2,18,8,7,6,5,8,22,36.4,14,8,0,8,8,26,1,0,Matches,eab85789
392,Aleksander Buksa,pl POL,FW,Genoa,it Serie A,18,2003,0.7,0,0,0,0,0,0,1,0.0,1,0,0,0,0,0,1,0,Matches,59f2d958
393,Alessandro Buongiorno,it ITA,DF,Torino,it Serie A,22,1999,13.1,20,9,9,8,3,9,13,69.2,4,12,6,6,31,51,44,0,Matches,4ae67f27
394,Sascha Burchert,de GER,GK,Greuther Fürth,de Bundesliga,31,1989,14.0,1,1,1,0,0,1,2,50.0,1,0,0,0,0,1,11,1,Matches,25bdea4b
395,Delano Burgzorg,nl NED,MF,Mainz 05,de Bundesliga,22,1998,0.3,1,1,1,0,0,0,1,0.0,1,0,0,0,0,1,0,0,Matches,05e2d5ea
396,Jonathan Burkardt,de GER,FWMF,Mainz 05,de Bundesliga,21,2000,29.0,17,8,0,10,7,6,25,24.0,19,31,5,26,8,25,16,0,Matches,05f99a4a
397,Roman Bürki,ch SUI,GK,Dortmund,de Bundesliga,30,1990,1.0,0,0,0,0,0,0,0,,0,0,0,0,0,0,0,0,Matches,9d12e142
398,Dan Burn,eng ENG,DF,Newcastle Utd,eng Premier League,29,1992,16.0,15,10,10,4,1,7,11,63.6,4,22,14,8,20,35,101,0,Matches,b2d31e83
399,Dan Burn,eng ENG,DF,Brighton,eng Premier League,29,1992,11.4,22,12,13,8,1,6,15,40.0,9,14,10,4,24,46,51,0,Matches,b2d31e83
400,Maxime Busi,be BEL,DF,Reims,fr Ligue 1,21,1999,14.4,26,15,20,5,1,19,36,52.8,17,19,5,14,17,43,28,0,Matches,7b082ec2
401,Gianluca Busio,us USA,MF,Venezia,it Serie A,19,2002,21.7,53,28,27,20,6,28,63,44.4,35,45,13,32,21,74,30,1,Matches,4a0b7f07
402,Oriol Busquets,es ESP,MF,Clermont Foot,fr Ligue 1,22,1999,2.2,3,3,0,3,0,2,6,33.3,4,7,4,3,1,4,2,0,Matches,49712367
403,Sergio Busquets,es ESP,MF,Barcelona,es La Liga,33,1988,35.5,93,49,31,48,14,46,83,55.4,37,44,8,36,45,138,31,0,Matches,5ab0ea87
404,Jack Butland,eng ENG,GK,Crystal Palace,eng Premier League,28,1993,8.5,0,0,0,0,0,0,0,,0,0,0,0,0,0,1,0,Matches,cc70a1d5
405,Adrián Butzke,es ESP,FW,Granada,es La Liga,22,1999,0.0,0,0,0,0,0,0,0,,0,0,0,0,0,0,0,0,Matches,505dce2b
406,Marcin Bułka,pl POL,GK,Nice,fr Ligue 1,21,1999,1.0,0,0,0,0,0,0,0,,0,0,0,0,0,0,0,0,Matches,db87a2c4
407,Jamie Bynoe-Gittens,eng ENG,MF,Dortmund,de Bundesliga,16,2004,1.5,3,2,0,2,1,2,5,40.0,3,4,1,3,1,4,1,0,Matches,10745192
408,Sam Byram,eng ENG,DF,Norwich City,eng Premier League,27,1993,11.4,24,15,17,6,1,19,27,70.4,8,21,11,10,22,46,48,0,Matches,1bf811d4
409,Erick Cabaco,uy URU,DF,Getafe,es La Liga,26,1995,4.5,2,1,1,1,0,2,5,40.0,3,5,2,3,4,6,10,0,Matches,e7ab4179
410,Willy Caballero,ar ARG,GK,Southampton,eng Premier League,39,1981,2.0,0,0,0,0,0,0,0,,0,0,0,0,0,0,2,1,Matches,a179d516
411,Rémy Cabella,fr FRA,MF,Montpellier,fr Ligue 1,31,1990,3.5,15,7,4,8,3,5,15,33.3,10,7,0,7,5,20,1,0,Matches,148e136f
412,Jimmy Cabot,fr FRA,DF,Angers,fr Ligue 1,27,1994,22.3,81,44,59,15,7,47,83,56.6,36,29,0,29,32,113,30,0,Matches,46359159
413,Jovane Cabral,cv CPV,FW,Lazio,it Serie A,23,1998,2.1,2,1,1,0,1,0,0,,0,1,1,0,1,3,1,0,Matches,e34e086c
414,Leandro Cabrera,uy URU,DF,Espanyol,es La Liga,30,1991,37.0,37,24,27,10,0,21,34,61.8,13,32,23,9,44,81,222,2,Matches,69cbc8b6
415,Liberato Cacace,nz NZL,DF,Empoli,it Serie A,20,2000,5.2,15,6,8,4,3,8,8,100.0,0,7,2,5,8,23,9,0,Matches,dd86e8e4
416,Martín Cáceres,uy URU,DF,Cagliari,it Serie A,34,1987,9.2,13,7,5,5,3,4,12,33.3,8,12,3,9,14,27,21,0,Matches,e94d79e3
417,Martín Cáceres,uy URU,DF,Levante,es La Liga,34,1987,7.4,2,2,2,0,0,1,5,20.0,4,2,2,0,11,13,16,1,Matches,e94d79e3
418,Anthony Caci,fr FRA,DF,Strasbourg,fr Ligue 1,24,1997,26.6,65,34,35,24,6,33,55,60.0,22,23,4,19,33,98,49,1,Matches,0118c54c
419,Mathieu Cafaro,fr FRA,MFFW,Reims,fr Ligue 1,24,1997,2.1,4,2,3,1,0,0,7,0.0,7,2,0,2,3,7,1,0,Matches,2a657da0
420,Yannick Cahuzac,fr FRA,MF,Lens,fr Ligue 1,36,1985,6.9,5,2,2,3,0,0,5,0.0,5,8,2,6,9,14,12,0,Matches,677ee102
421,Felipe Caicedo,ec ECU,FW,Genoa,it Serie A,32,1988,3.2,3,3,0,2,1,0,1,0.0,1,1,0,1,0,3,4,0,Matches,93b891d1
422,Felipe Caicedo,ec ECU,FWDF,Inter,it Serie A,32,1988,0.3,0,0,0,0,0,0,0,,0,1,0,1,0,0,0,0,Matches,93b891d1
423,Moisés Caicedo,ec ECU,MF,Brighton,eng Premier League,19,2001,7.3,16,10,7,7,2,5,12,41.7,7,18,4,14,10,26,7,0,Matches,16264a81
424,Marc-Aurèle Caillard,fr FRA,GK,Metz,fr Ligue 1,27,1994,17.1,0,0,0,0,0,0,2,0.0,2,0,0,0,2,2,9,1,Matches,5ee6e943
425,Jens Cajuste,se SWE,MFFW,Reims,fr Ligue 1,21,1999,4.0,10,6,6,2,2,6,17,35.3,11,7,2,5,5,15,6,0,Matches,928a4a61
426,Cala,es ESP,DF,Cádiz,es La Liga,31,1989,10.5,9,4,9,0,0,8,17,47.1,9,12,6,6,12,21,56,0,Matches,fe05804b
427,Davide Calabria,it ITA,DF,Milan,it Serie A,24,1996,23.5,62,37,31,23,8,37,72,51.4,35,25,5,20,23,85,40,1,Matches,2146785a
428,Riccardo Calafiori,it ITA,DF,Genoa,it Serie A,19,2002,0.9,1,0,0,0,1,1,2,50.0,1,2,1,1,2,3,4,0,Matches,aded8e6f
429,Riccardo Calafiori,it ITA,DF,Roma,it Serie A,19,2002,1.9,5,4,2,2,1,1,5,20.0,4,3,0,3,3,8,1,0,Matches,aded8e6f
430,Mattia Caldara,it ITA,DF,Venezia,it Serie A,27,1994,30.0,48,28,30,15,3,20,34,58.8,14,49,37,12,62,110,147,1,Matches,ac7e640b
431,Calderón,es ESP,DF,Betis,es La Liga,21,2000,0.7,2,0,1,0,1,1,3,33.3,2,0,0,0,0,2,2,0,Matches,da4e70e5
432,Fernando Calero,es ESP,DF,Espanyol,es La Liga,25,1995,12.1,17,10,12,5,0,8,13,61.5,5,7,2,5,16,33,63,1,Matches,41b3069f
433,Duje Ćaleta-Car,hr CRO,DF,Marseille,fr Ligue 1,24,1996,22.9,21,8,15,6,0,11,14,78.6,3,11,7,4,24,45,55,2,Matches,94f8d10c
434,Hakan Çalhanoğlu,tr TUR,MF,Inter,it Serie A,27,1994,27.6,41,23,16,19,6,11,40,27.5,29,29,5,24,25,66,12,0,Matches,cd0fa27b
435,Daniel Caligiuri,it ITA,DFMF,Augsburg,de Bundesliga,33,1988,22.3,46,30,17,26,3,27,73,37.0,46,36,5,31,18,64,33,0,Matches,d1273f09
436,José Callejón,es ESP,FW,Fiorentina,it Serie A,34,1987,14.4,15,6,6,6,3,13,31,41.9,18,6,0,6,3,18,1,1,Matches,78841da9
437,Lucas Calodat,fr FRA,DF,Saint-Étienne,fr Ligue 1,19,2002,0.0,0,0,0,0,0,0,0,,0,0,0,0,0,0,0,0,Matches,7a72e960
438,Dominic Calvert-Lewin,eng ENG,FW,Everton,eng Premier League,24,1997,14.3,11,8,1,6,4,3,8,37.5,5,5,2,3,3,14,12,0,Matches,59e6e5bf
439,Mahdi Camara,fr FRA,MFDF,Saint-Étienne,fr Ligue 1,23,1998,34.1,101,57,39,50,12,39,70,55.7,31,44,8,36,58,159,35,1,Matches,8577e60a
440,Mamadou Camara,fr FRA,FW,Troyes,fr Ligue 1,20,2001,0.4,1,1,1,0,0,0,0,,0,0,0,0,0,1,0,0,Matches,316e70c7
441,Víctor Camarasa,es ESP,MFFW,Betis,es La Liga,27,1994,1.2,2,1,1,1,0,0,1,0.0,1,2,1,1,2,4,2,0,Matches,b2d03887
442,Eduardo Camavinga,fr FRA,MF,Real Madrid,es La Liga,18,2002,13.7,52,35,22,20,10,20,38,52.6,18,20,2,18,17,69,14,1,Matches,7b9c2d84
443,Eduardo Camavinga,fr FRA,MF,Rennes,fr Ligue 1,18,2002,1.6,4,1,2,1,1,2,5,40.0,3,1,1,0,1,5,3,0,Matches,7b9c2d84
444,Andrea Cambiaso,it ITA,DF,Genoa,it Serie A,21,2000,19.9,46,20,28,14,4,18,32,56.3,14,33,8,25,23,69,37,1,Matches,247ed022
445,José Campaña,es ESP,MF,Levante,es La Liga,28,1993,15.8,27,16,13,10,4,12,32,37.5,20,13,2,11,21,48,19,1,Matches,61220da2
446,Chem Campbell,wls WAL,MF,Wolves,eng Premier League,18,2002,0.1,1,1,0,1,0,0,0,,0,0,0,0,0,1,0,0,Matches,6f711f67
447,Emre Can,de GER,DFMF,Dortmund,de Bundesliga,27,1994,18.8,36,22,20,16,0,15,30,50.0,15,26,10,16,36,72,40,2,Matches,a65ce836
448,Sergio Canales,es ESP,MF,Betis,es La Liga,30,1991,31.0,24,14,8,12,4,10,35,28.6,25,16,1,15,10,34,12,0,Matches,a6de370d
449,Matteo Cancellieri,it ITA,MFDF,Hellas Verona,it Serie A,19,2002,2.5,4,4,2,2,0,0,5,0.0,5,2,0,2,1,5,0,0,Matches,b6a1cdf9
450,João Cancelo,pt POR,DF,Manchester City,eng Premier League,27,1994,35.9,83,54,33,35,15,46,91,50.5,45,25,3,22,59,142,45,1,Matches,bd6351cd
451,Fali Candé,gw GNB,DF,Metz,fr Ligue 1,23,1998,10.8,30,18,13,15,2,13,31,41.9,18,11,2,9,6,36,21,0,Matches,3cc4bb19
452,Antonio Candreva,it ITA,MF,Sampdoria,it Serie A,34,1987,34.7,27,16,9,11,7,19,55,34.5,36,23,2,21,33,60,19,0,Matches,356c9002
453,Sergi Canós,es ESP,DFFW,Brentford,eng Premier League,24,1997,23.1,56,25,32,15,9,33,60,55.0,27,32,3,29,22,78,38,0,Matches,1137759d
454,Álex Cantero,es ESP,FWMF,Levante,es La Liga,21,2000,6.8,6,4,2,3,1,1,8,12.5,7,2,0,2,1,7,0,0,Matches,4aa253fd
455,Todd Cantwell,eng ENG,FWMF,Norwich City,eng Premier League,23,1998,4.9,15,13,8,6,1,6,17,35.3,11,2,0,2,3,18,2,0,Matches,f63d8a4b
456,Ander Capa,es ESP,DF,Athletic Club,es La Liga,29,1992,0.0,0,0,0,0,0,0,0,,0,0,0,0,0,0,0,0,Matches,37f1cf47
457,Pierrick Capelle,fr FRA,MFDF,Angers,fr Ligue 1,34,1987,13.3,36,24,16,17,3,18,52,34.6,34,12,1,11,16,52,20,0,Matches,79b2399c
458,Leonardo Capezzi,it ITA,MF,Salernitana,it Serie A,26,1995,1.9,3,1,0,3,0,1,4,25.0,3,8,4,4,0,3,2,0,Matches,07ea0ef2
459,Étienne Capoue,fr FRA,MF,Villarreal,es La Liga,33,1988,25.4,44,26,18,23,3,15,28,53.6,13,17,5,12,35,79,51,0,Matches,5acc4a10
460,Gianluca Caprari,it ITA,MFFW,Hellas Verona,it Serie A,28,1993,30.4,43,25,10,22,11,17,51,33.3,34,32,0,32,4,47,7,0,Matches,54e53b7e
461,Francesco Caputo,it ITA,FW,Sampdoria,it Serie A,33,1987,31.0,5,2,1,3,1,1,6,16.7,5,5,0,5,2,7,10,0,Matches,5bd72174
462,Francesco Caputo,it ITA,FW,Sassuolo,it Serie A,33,1987,1.7,0,0,0,0,0,0,0,,0,0,0,0,0,0,0,0,Matches,5bd72174
463,Maxence Caqueret,fr FRA,MF,Lyon,fr Ligue 1,21,2000,25.9,73,40,29,36,8,30,80,37.5,50,38,10,28,43,116,26,2,Matches,f81ef10d
464,Andrea Carboni,it ITA,DF,Cagliari,it Serie A,20,2001,24.6,53,24,33,16,4,19,42,45.2,23,42,15,27,27,80,87,0,Matches,f7e2af2c
465,Isaac Carcelen,es ESP,DFMF,Cádiz,es La Liga,28,1993,17.2,43,29,29,12,2,28,56,50.0,28,25,6,19,34,77,42,0,Matches,c4b888df
466,Cárdenas,es ESP,GK,Levante,es La Liga,24,1997,24.0,1,1,1,0,0,0,3,0.0,3,0,0,0,1,2,19,0,Matches,e1846dde
467,Irvin Cardona,fr FRA,FWMF,Brest,fr Ligue 1,23,1997,14.8,13,7,5,4,4,3,16,18.8,13,10,0,10,5,18,17,0,Matches,5e080f73
468,Igor Carioca,br BRA,DF,Lorient,fr Ligue 1,24,1996,17.5,27,16,16,8,3,15,43,34.9,28,17,2,15,25,52,28,0,Matches,e3e32fbb
469,Carlo,es ESP,MF,Villarreal,es La Liga,20,2001,0.1,0,0,0,0,0,0,0,,0,0,0,0,0,0,0,0,Matches,8249ff06
470,Diego Carlos,br BRA,DF,Sevilla,es La Liga,28,1993,32.9,35,24,20,13,2,16,24,66.7,8,48,33,15,24,59,120,5,Matches,b4a014b1
471,Carmona,es ESP,DF,Sevilla,es La Liga,19,2002,0.3,0,0,0,0,0,0,0,,0,0,0,0,1,1,0,0,Matches,2dce876a
472,Yannick Carrasco,be BEL,MFFW,Atlético Madrid,es La Liga,27,1993,28.7,34,19,16,12,6,19,44,43.2,25,26,5,21,19,53,12,2,Matches,de39485a
473,Guido Carrillo,ar ARG,FW,Elche,es La Liga,30,1991,13.0,7,4,2,4,1,3,13,23.1,10,9,2,7,1,8,27,0,Matches,8f898ba8
474,Dani Carvajal,es ESP,DF,Real Madrid,es La Liga,29,1992,17.2,43,28,21,15,7,15,26,57.7,11,22,8,14,20,63,38,2,Matches,4958bfb2
475,William Carvalho,pt POR,MF,Betis,es La Liga,29,1992,20.1,49,33,20,25,4,15,40,37.5,25,18,7,11,16,65,20,0,Matches,dee86451
476,Nicolò Casale,it ITA,DF,Hellas Verona,it Serie A,23,1998,28.7,46,30,25,19,2,21,37,56.8,16,31,12,19,49,95,95,0,Matches,3f5f38fb
477,Casemiro,br BRA,MF,Real Madrid,es La Liga,29,1992,28.5,79,51,45,30,4,30,67,44.8,37,65,19,46,38,117,65,3,Matches,4d224fe8
478,Matty Cash,pl POL,DF,Aston Villa,eng Premier League,23,1997,37.5,89,50,52,34,3,47,78,60.3,31,54,16,38,49,138,100,2,Matches,2389cdc2
479,Kiko Casilla,es ESP,GK,Elche,es La Liga,34,1986,14.0,0,0,0,0,0,0,1,0.0,1,0,0,0,1,1,2,2,Matches,58bc7d18
480,Moreto Cassamã,gw GNB,MF,Reims,fr Ligue 1,23,1998,8.9,12,6,7,4,1,3,19,15.8,16,10,5,5,9,21,5,0,Matches,f54d2149
481,Francesco Cassata,it ITA,MF,Genoa,it Serie A,24,1997,0.1,0,0,0,0,0,0,0,,0,0,0,0,0,0,0,0,Matches,96960855
482,Timothy Castagne,be BEL,DF,Leicester City,eng Premier League,25,1995,23.6,67,31,38,22,7,27,43,62.8,16,28,9,19,29,96,54,1,Matches,197640fd
483,Koen Casteels,be BEL,GK,Wolfsburg,de Bundesliga,29,1992,28.0,0,0,0,0,0,0,1,0.0,1,0,0,0,0,0,9,2,Matches,db401046
484,Jean-Charles Castelletto,cm CMR,DF,Nantes,fr Ligue 1,26,1995,27.9,45,24,27,17,1,25,35,71.4,10,38,27,11,30,75,73,0,Matches,e0f3a1f6
485,Samu Castillejo,es ESP,MF,Milan,it Serie A,26,1995,1.4,4,2,0,2,2,1,8,12.5,7,4,1,3,2,6,1,0,Matches,130a7a3f
486,Gonzalo Castro,de GER,MFFW,Arminia,de Bundesliga,34,1987,4.8,8,3,4,4,0,1,5,20.0,4,3,0,3,3,11,3,0,Matches,68829001
487,Jonny Castro,es ESP,DF,Wolves,eng Premier League,27,1994,11.4,25,15,13,11,1,11,20,55.0,9,14,3,11,13,38,11,0,Matches,e28868f3
488,Gaetano Castrovilli,it ITA,MF,Fiorentina,it Serie A,24,1997,15.5,25,17,15,6,4,12,23,52.2,11,18,4,14,11,36,6,0,Matches,0728bebe
489,Danilo Cataldi,it ITA,MF,Lazio,it Serie A,26,1994,19.0,36,17,15,17,4,12,38,31.6,26,24,12,12,17,53,19,1,Matches,ba3d3bea
490,Catena,es ESP,DF,Rayo Vallecano,es La Liga,26,1994,36.0,39,23,24,15,0,25,42,59.5,17,26,19,7,30,69,168,3,Matches,274ab13c
491,Craig Cathcart,nir NIR,DF,Watford,eng Premier League,32,1989,26.6,32,15,25,6,1,16,30,53.3,14,39,29,10,28,60,132,3,Matches,89e4b358
492,Edinson Cavani,uy URU,FW,Manchester Utd,eng Premier League,34,1987,8.5,4,1,0,3,1,2,8,25.0,6,6,0,6,2,6,8,0,Matches,527f063d
493,Dani Ceballos,es ESP,MF,Real Madrid,es La Liga,24,1996,3.1,7,5,4,3,0,1,5,20.0,4,8,2,6,4,11,2,0,Matches,c0617e2b
494,Pietro Ceccaroni,it ITA,DF,Venezia,it Serie A,25,1995,34.7,55,31,33,18,4,25,36,69.4,11,45,32,13,30,85,143,0,Matches,4d1efb48
495,Federico Ceccherini,it ITA,DF,Hellas Verona,it Serie A,29,1992,26.2,32,16,19,10,3,19,33,57.6,14,13,8,5,50,82,76,1,Matches,d9624b51
496,Emil Ceide,no NOR,MFFW,Sassuolo,it Serie A,19,2001,0.6,1,1,0,1,0,1,2,50.0,1,1,0,1,0,1,0,0,Matches,98a84572
497,Zeki Çelik,tr TUR,DF,Lille,fr Ligue 1,24,1997,30.0,64,37,43,17,4,36,63,57.1,27,32,9,23,43,107,62,2,Matches,31a62dc7
498,Fabien Centonze,fr FRA,DF,Metz,fr Ligue 1,25,1996,17.6,33,21,22,9,2,13,32,40.6,19,37,8,29,32,65,51,0,Matches,3c6bbbab
499,Luca Ceppitelli,it ITA,DF,Cagliari,it Serie A,31,1989,16.1,23,12,13,10,0,16,27,59.3,11,21,14,7,25,48,54,0,Matches,7d50454d
500,Franco Cervi,ar ARG,MF,Celta Vigo,es La Liga,27,1994,20.0,73,41,35,22,16,33,77,42.9,44,38,2,36,21,94,19,0,Matches,5e1028e5
501,Leonardo César Jardim,br BRA,GK,Lille,fr Ligue 1,26,1995,17.0,,0,,,,,,,,,,,1,,,,Matches,f5dfc256
502,Damir Ceter,co COL,FW,Cagliari,it Serie A,23,1997,0.1,0,0,0,0,0,0,0,,0,0,0,0,0,0,0,0,Matches,eade5337
503,Julian Chabot,de GER,DF,Sampdoria,it Serie A,23,1998,5.4,12,10,8,4,0,8,10,80.0,2,7,4,3,9,21,28,1,Matches,ae7058f9
504,Julian Chabot,de GER,DF,Köln,de Bundesliga,23,1998,2.3,8,3,4,4,0,2,5,40.0,3,4,2,2,3,11,5,1,Matches,ae7058f9
505,El Chadaille Bitshiabu,fr FRA,DF,Paris S-G,fr Ligue 1,16,2005,0.1,0,0,0,0,0,0,0,,0,0,0,0,0,0,2,0,Matches,2180c761
506,Nassim Chadli,fr FRA,MFDF,Troyes,fr Ligue 1,20,2001,1.1,5,3,3,0,2,2,4,50.0,2,1,0,1,0,5,0,0,Matches,5c61496e
507,Kayky Chagas,br BRA,FW,Manchester City,eng Premier League,18,2003,0.1,0,0,0,0,0,0,0,,0,0,0,0,0,0,0,0,Matches,17734ea0
508,Mehdi Chahiri,ma MAR,DF,Strasbourg,fr Ligue 1,25,1996,0.2,1,1,1,0,0,1,1,100.0,0,0,0,0,0,1,0,0,Matches,1787195f
509,Trevoh Chalobah,eng ENG,DF,Chelsea,eng Premier League,22,1999,16.1,40,27,22,18,0,24,31,77.4,7,16,6,10,19,59,43,2,Matches,5515376c
510,Calum Chambers,eng ENG,DF,Arsenal,eng Premier League,26,1995,1.9,5,3,3,1,1,3,4,75.0,1,6,3,3,0,5,10,0,Matches,dc6f5bdd
511,Calum Chambers,eng ENG,DF,Aston Villa,eng Premier League,26,1995,9.2,16,8,10,6,0,4,6,66.7,2,14,8,6,5,21,42,0,Matches,dc6f5bdd
512,Dylan Chambost,fr FRA,MFFW,Troyes,fr Ligue 1,23,1997,8.4,16,11,6,9,1,4,25,16.0,21,9,2,7,9,25,4,0,Matches,dbde4959
513,Timothy Chandler,us USA,DF,Eint Frankfurt,de Bundesliga,31,1990,13.5,18,12,10,8,0,11,24,45.8,13,10,3,7,19,37,28,1,Matches,b3b7f5a6
514,Chapela,es ESP,MF,Cádiz,es La Liga,22,1999,4.4,4,2,1,0,3,2,4,50.0,2,6,1,5,4,8,5,0,Matches,9ed40a69
515,Brendan Chardonnet,fr FRA,DF,Brest,fr Ligue 1,26,1994,29.8,44,25,32,11,1,29,40,72.5,11,42,29,13,55,99,141,0,Matches,16aa7d4c
516,Xavier Chavalerin,fr FRA,MF,Troyes,fr Ligue 1,30,1991,30.2,49,26,19,25,5,12,55,21.8,43,32,5,27,38,87,36,0,Matches,279ddf6a
517,Xavier Chavalerin,fr FRA,MF,Reims,fr Ligue 1,30,1991,2.4,4,4,2,1,1,1,3,33.3,2,2,0,2,5,9,2,1,Matches,279ddf6a
518,Justin Che,us USA,FWDF,Hoffenheim,de Bundesliga,17,2003,0.5,2,0,1,0,1,1,2,50.0,1,0,0,0,1,3,0,0,Matches,3c569f37
519,Chema,es ESP,MF,Getafe,es La Liga,29,1992,0.5,0,0,0,0,0,0,1,0.0,1,0,0,0,0,0,0,0,Matches,7f203b54
520,Rayan Cherki,fr FRA,MFFW,Lyon,fr Ligue 1,17,2003,4.9,6,2,1,3,2,4,9,44.4,5,2,0,2,1,7,0,0,Matches,b34c63a5
521,Denis Cheryshev,ru RUS,MF,Valencia,es La Liga,30,1990,6.3,14,5,6,1,7,6,15,40.0,9,9,1,8,9,23,9,0,Matches,0ac94a23
522,Daniel Chesters,eng ENG,MF,West Ham,eng Premier League,19,2002,0.0,0,0,0,0,0,0,0,,0,0,0,0,0,0,0,0,Matches,240c8ab6
523,Giorgio Chiellini,it ITA,DF,Juventus,it Serie A,36,1984,15.0,22,13,17,4,1,7,13,53.8,6,24,18,6,22,44,59,0,Matches,e85fb9b8
524,Federico Chiesa,it ITA,MFFW,Juventus,it Serie A,23,1997,9.6,26,19,9,9,8,12,26,46.2,14,7,0,7,4,30,3,0,Matches,b0f7e36c
525,Ben Chilwell,eng ENG,DF,Chelsea,eng Premier League,24,1996,6.0,8,3,2,6,0,2,5,40.0,3,7,0,7,4,12,14,1,Matches,d2424d1b
526,Chiquinho,pt POR,DFFW,Wolves,eng Premier League,21,2000,2.3,9,6,4,5,0,4,5,80.0,1,5,0,5,2,11,1,0,Matches,dc6c2f02
527,Vlad Chiricheș,ro ROU,DF,Sassuolo,it Serie A,31,1989,25.6,28,15,19,9,0,10,21,47.6,11,34,21,13,41,69,71,4,Matches,c316607a
528,Pedro Chirivella,es ESP,MF,Nantes,fr Ligue 1,24,1997,29.3,49,31,14,26,9,25,70,35.7,45,23,2,21,37,86,11,0,Matches,68a26d51
529,Joris Chotard,fr FRA,MF,Montpellier,fr Ligue 1,19,2001,32.6,59,30,33,23,3,36,78,46.2,42,27,15,12,42,101,56,0,Matches,7909ffa4
530,Hamza Choudhury,eng ENG,DFMF,Leicester City,eng Premier League,23,1997,3.2,9,3,4,4,1,3,5,60.0,2,0,0,0,12,21,10,0,Matches,7d2d3329
531,Andreas Christensen,dk DEN,DF,Chelsea,eng Premier League,25,1996,16.6,14,8,9,4,1,4,7,57.1,3,14,6,8,29,43,57,1,Matches,1cb49278
532,Max Christiansen,de GER,MF,Greuther Fürth,de Bundesliga,24,1996,22.8,46,25,19,22,5,18,43,41.9,25,52,16,36,68,114,56,0,Matches,e7b899b8
533,Carney Chukwuemeka,eng ENG,MFFW,Aston Villa,eng Premier League,17,2003,3.3,7,1,2,5,0,3,5,60.0,2,3,0,3,2,9,2,1,Matches,b2f9c73e
534,Samuel Chukwueze,ng NGA,MF,Villarreal,es La Liga,22,1999,14.8,13,9,6,5,2,3,6,50.0,3,7,0,7,5,18,4,0,Matches,b8a642fc
535,Víctor Chust,es ESP,DF,Cádiz,es La Liga,21,2000,20.3,19,10,14,4,1,11,17,64.7,6,20,8,12,16,35,87,0,Matches,ec1a731e
536,Riccardo Ciervo,it ITA,MFDF,Sampdoria,it Serie A,19,2002,2.5,8,3,4,3,1,2,6,33.3,4,1,0,1,2,10,2,0,Matches,da77b60b
537,Jasper Cillessen,nl NED,GK,Valencia,es La Liga,32,1989,16.2,0,0,0,0,0,0,1,0.0,1,0,0,0,1,1,6,0,Matches,04ac8285
538,Pathé Ciss,sn SEN,MF,Rayo Vallecano,es La Liga,27,1994,12.2,31,15,20,8,3,12,26,46.2,14,16,6,10,30,61,27,0,Matches,9a0408b6
539,Moustapha Cissé,gn GUI,FW,Atalanta,it Serie A,17,2003,0.4,1,0,0,1,0,0,3,0.0,3,0,0,0,0,1,0,0,Matches,ee3c4b3f
540,Giorgio Cittadini,it ITA,DF,Atalanta,it Serie A,19,2002,0.0,0,0,0,0,0,0,0,,0,0,0,0,1,1,0,0,Matches,e4ba67f2
541,Ciaran Clark,ie IRL,DF,Newcastle Utd,eng Premier League,31,1989,11.3,13,10,4,7,2,9,14,64.3,5,14,11,3,13,26,43,1,Matches,2b91cf8e
542,Alexis Claude-Maurice,fr FRA,MF,Nice,fr Ligue 1,23,1998,2.3,2,0,1,0,1,1,4,25.0,3,7,0,7,3,5,1,0,Matches,741418c3
543,Jonathan Clauss,fr FRA,DF,Lens,fr Ligue 1,28,1992,33.8,63,34,33,20,10,23,56,41.1,33,43,1,42,73,136,51,0,Matches,5219ab4a
544,Carlos Clerc,es ESP,DF,Levante,es La Liga,29,1992,16.8,35,17,21,10,4,7,19,36.8,12,8,3,5,26,61,32,1,Matches,33a61a52
545,Tom Cleverley,eng ENG,MF,Watford,eng Premier League,31,1989,18.0,37,20,19,17,1,18,33,54.5,15,23,6,17,18,55,19,3,Matches,6cdd8245
546,Nathaniel Clyne,eng ENG,DF,Crystal Palace,eng Premier League,30,1991,15.0,21,10,11,9,1,10,20,50.0,10,7,2,5,15,36,32,0,Matches,0442183b
547,Conor Coady,eng ENG,DF,Wolves,eng Premier League,28,1993,37.3,31,14,23,7,1,16,28,57.1,12,46,40,6,28,59,140,0,Matches,2928dca2
548,Marcus Coco,fr FRA,MFDF,Nantes,fr Ligue 1,25,1996,10.3,34,14,17,11,6,8,18,44.4,10,11,1,10,10,44,15,0,Matches,3010aefb
549,Coke,es ESP,DF,Levante,es La Liga,34,1987,1.3,3,2,1,1,1,3,4,75.0,1,1,0,1,2,5,7,0,Matches,6d8f8441
550,Séamus Coleman,ie IRL,DF,Everton,eng Premier League,32,1988,29.5,61,36,35,16,10,33,51,64.7,18,30,11,19,32,93,80,2,Matches,0420d84f
551,Álex Collado,es ESP,MFFW,Granada,es La Liga,22,1999,11.3,27,12,6,16,5,12,31,38.7,19,28,2,26,6,33,11,0,Matches,85dace26
552,Ebrima Colley,gm GAM,FWMF,Spezia,it Serie A,21,2000,4.4,6,1,3,2,1,1,7,14.3,6,8,0,8,3,9,2,0,Matches,bf356094
553,Omar Colley,gm GAM,DF,Sampdoria,it Serie A,28,1992,30.5,47,36,32,14,1,22,32,68.8,10,31,19,12,80,127,135,2,Matches,8b95acda
554,Nathan Collins,ie IRL,DF,Burnley,eng Premier League,20,2001,18.6,37,15,27,8,2,17,27,63.0,10,38,25,13,24,61,83,2,Matches,a8c19eb8
555,Kingsley Coman,fr FRA,MFFW,Bayern Munich,de Bundesliga,25,1996,15.1,14,8,1,9,4,5,16,31.3,11,14,0,14,8,22,5,0,Matches,042e8a49
556,Eray Cömert,ch SUI,DF,Valencia,es La Liga,23,1998,4.5,5,3,4,1,0,3,6,50.0,3,3,2,1,2,7,6,0,Matches,15937e17
557,Santi Comesaña,es ESP,MF,Rayo Vallecano,es La Liga,24,1996,29.8,87,56,45,33,9,40,104,38.5,64,46,6,40,33,120,30,0,Matches,5ae499d0
558,Diego Conde,es ESP,GK,Getafe,es La Liga,22,1998,0.1,0,0,0,0,0,0,0,,0,0,0,0,0,0,0,0,Matches,4eae5bc4
559,Aaron Connolly,ie IRL,FWMF,Brighton,eng Premier League,21,2000,1.7,0,0,0,0,0,0,1,0.0,1,2,0,2,0,0,0,0,Matches,27c01749
560,Andrea Consigli,it ITA,GK,Sassuolo,it Serie A,34,1987,36.9,0,0,0,0,0,0,2,0.0,2,0,0,0,0,0,23,3,Matches,8cabdc1e
561,Abdu Conté,pt POR,DF,Troyes,fr Ligue 1,23,1998,15.0,22,12,16,5,1,12,24,50.0,12,12,2,10,4,26,10,0,Matches,cfa49cc1
562,Andrea Conti,it ITA,DFMF,Sampdoria,it Serie A,27,1994,2.6,4,2,2,1,1,3,6,50.0,3,4,0,4,7,11,4,0,Matches,8fef5412
563,Andrea Conti,it ITA,DF,Milan,it Serie A,27,1994,0.1,0,0,0,0,0,0,0,,0,0,0,0,0,0,0,0,Matches,8fef5412
564,Liam Cooper,sct SCO,DF,Leeds United,eng Premier League,29,1991,20.2,41,23,27,13,1,23,33,69.7,10,29,18,11,43,84,72,2,Matches,dc64b8b3
565,Lucas Copado,de GER,MF,Bayern Munich,de Bundesliga,17,2004,0.2,1,0,1,0,0,1,1,100.0,0,0,0,0,0,1,0,0,Matches,8356931a
566,Diego Coppola,it ITA,DF,Hellas Verona,it Serie A,17,2003,2.8,8,4,4,4,0,3,3,100.0,0,5,1,4,4,12,5,0,Matches,22ae86f9
567,Francis Coquelin,fr FRA,MF,Villarreal,es La Liga,30,1991,9.2,26,17,9,11,6,11,20,55.0,9,15,5,10,19,45,11,0,Matches,a6951bf8
568,Sébastien Corchia,fr FRA,DFMF,Nantes,fr Ligue 1,30,1990,14.7,33,20,17,11,5,24,42,57.1,18,24,3,21,13,46,36,0,Matches,0e7ccfc4
569,Sergio Córdova,ve VEN,FWMF,Augsburg,de Bundesliga,23,1997,3.6,4,3,2,2,0,1,2,50.0,1,4,0,4,0,4,4,0,Matches,229cd98a
570,Jack Cork,eng ENG,MF,Burnley,eng Premier League,32,1989,18.6,20,6,6,11,3,7,20,35.0,13,17,4,13,17,37,29,1,Matches,74e12f1e
571,Maxwel Cornet,ci CIV,FWMF,Burnley,eng Premier League,24,1996,19.6,16,9,7,5,4,7,15,46.7,8,13,4,9,10,26,14,0,Matches,beb391dd
572,Maxwel Cornet,ci CIV,DF,Lyon,fr Ligue 1,24,1996,0.7,3,1,1,0,2,3,4,75.0,1,0,0,0,1,4,1,0,Matches,beb391dd
573,Jesús Corona,mx MEX,FWMF,Sevilla,es La Liga,28,1993,12.9,12,7,7,5,0,3,6,50.0,3,4,0,4,8,20,6,0,Matches,fb938d24
574,Ángel Correa,ar ARG,FWMF,Atlético Madrid,es La Liga,26,1995,20.6,16,8,5,10,1,7,29,24.1,22,25,2,23,10,26,4,0,Matches,01eb744d
575,Joaquín Correa,ar ARG,FW,Inter,it Serie A,26,1994,11.4,11,5,2,6,3,1,13,7.7,12,8,1,7,3,14,2,0,Matches,45b9b619
576,Thierry Correia,pt POR,DF,Valencia,es La Liga,22,1999,15.7,35,23,26,6,3,14,29,48.3,15,20,5,15,19,54,27,0,Matches,c78b352d
577,Danny da Costa,de GER,DFMF,Eint Frankfurt,de Bundesliga,28,1993,8.1,15,4,6,7,2,6,18,33.3,12,14,1,13,11,26,18,1,Matches,5ddb8f9f
578,David Pereira da Costa,pt POR,MFFW,Lens,fr Ligue 1,20,2001,16.3,22,12,9,6,7,11,26,42.3,15,12,0,12,13,35,5,0,Matches,59948ef7
579,Hélder Costa,ao ANG,MF,Leeds United,eng Premier League,27,1994,0.2,0,0,0,0,0,0,0,,0,1,0,1,0,0,0,0,Matches,f13d02a6
580,Hélder Costa,ao ANG,MFFW,Valencia,es La Liga,27,1994,12.4,27,16,11,9,7,14,41,34.1,27,12,1,11,3,30,9,0,Matches,f13d02a6
581,Jaume Costa,es ESP,DF,Mallorca,es La Liga,33,1988,20.3,35,26,23,7,5,23,31,74.2,8,22,7,15,23,58,55,0,Matches,808d48f3
582,Benoît Costil,fr FRA,GK,Bordeaux,fr Ligue 1,34,1987,25.0,1,0,1,0,0,1,2,50.0,1,0,0,0,0,1,6,3,Matches,2434f24a
583,Vladimír Coufal,cz CZE,DF,West Ham,eng Premier League,28,1992,24.5,45,25,24,14,7,18,36,50.0,18,31,9,22,22,67,64,1,Matches,fdf3cb77
584,Kalifa Coulibaly,ml MLI,FW,Nantes,fr Ligue 1,29,1991,9.4,5,1,1,1,3,0,4,0.0,4,2,2,0,0,5,11,0,Matches,9980269a
585,Lassana Coulibaly,ml MLI,MF,Salernitana,it Serie A,25,1996,25.9,58,32,29,26,3,24,62,38.7,38,40,13,27,22,80,27,0,Matches,85a44ecc
586,Mamadou Coulibaly,sn SEN,MF,Salernitana,it Serie A,22,1999,9.0,15,12,8,5,2,7,20,35.0,13,9,0,9,11,26,9,0,Matches,c976160c
587,Tanguy Coulibaly,fr FRA,FWMF,Stuttgart,de Bundesliga,20,2001,12.0,27,15,14,11,2,9,19,47.4,10,14,2,12,4,31,10,0,Matches,05ba9d7c
588,Thibaut Courtois,be BEL,GK,Real Madrid,es La Liga,29,1992,36.0,1,0,1,0,0,1,2,50.0,1,0,0,0,0,1,9,1,Matches,1840e36d
589,Philippe Coutinho,br BRA,MFFW,Aston Villa,eng Premier League,29,1992,14.8,17,12,4,11,2,6,21,28.6,15,11,1,10,7,24,4,0,Matches,0ef89a37
590,Philippe Coutinho,br BRA,MFFW,Barcelona,es La Liga,29,1992,5.6,6,3,3,3,0,3,11,27.3,8,3,0,3,4,10,3,0,Matches,0ef89a37
591,Nicolas Cozza,fr FRA,DF,Montpellier,fr Ligue 1,22,1999,30.8,80,47,50,23,7,35,65,53.8,30,35,19,16,38,118,82,1,Matches,8f325097
592,Alessio Cragno,it ITA,GK,Cagliari,it Serie A,27,1994,35.0,3,3,2,1,0,3,3,100.0,0,0,0,0,1,4,14,1,Matches,f554e29b
593,Aaron Cresswell,eng ENG,DF,West Ham,eng Premier League,31,1989,30.3,28,18,18,6,4,13,25,52.0,12,31,18,13,35,63,66,0,Matches,4f974391
594,Charlie Cresswell,eng ENG,DF,Leeds United,eng Premier League,18,2002,1.6,5,2,1,4,0,3,3,100.0,0,1,1,0,2,7,6,0,Matches,4654e5f5
595,Domenico Criscito,it ITA,DF,Genoa,it Serie A,34,1986,18.0,37,21,19,14,4,16,25,64.0,9,22,12,10,39,76,57,0,Matches,35dd6d80
596,Bryan Cristante,it ITA,MF,Roma,it Serie A,26,1995,29.8,79,39,31,39,9,37,69,53.6,32,31,5,26,40,119,45,0,Matches,16657b95
597,Cristo,es ESP,DF,Real Sociedad,es La Liga,21,2000,0.2,0,0,0,0,0,0,0,,0,0,0,0,0,0,0,0,Matches,ad81ba78
598,Enzo Crivelli,fr FRA,FWMF,Saint-Étienne,fr Ligue 1,26,1995,1.1,1,0,0,0,1,0,0,,0,0,0,0,0,1,1,0,Matches,06f33dc8
599,Domen Črnigoj,si SVN,MF,Venezia,it Serie A,25,1995,20.9,21,13,7,11,3,11,29,37.9,18,27,8,19,24,45,42,0,Matches,22cd43d2
600,Giovanni Crociata,it ITA,FW,Empoli,it Serie A,23,1997,0.2,0,0,0,0,0,0,1,0.0,1,0,0,0,0,0,0,0,Matches,8c964914
601,Juan Cruz Armada,es ESP,DF,Osasuna,es La Liga,29,1992,21.5,28,21,15,12,1,8,16,50.0,8,15,12,3,16,44,58,1,Matches,a56da3ba
602,Juan Cuadrado,co COL,DFMF,Juventus,it Serie A,33,1988,27.6,48,23,30,13,5,30,55,54.5,25,23,5,18,29,77,34,0,Matches,0ab1f153
603,Cucho,co COL,MFFW,Watford,eng Premier League,22,1999,12.7,13,5,5,5,3,5,27,18.5,22,13,1,12,5,18,9,0,Matches,71b47ab9
604,Marc Cucurella,es ESP,DF,Brighton,eng Premier League,23,1998,34.3,93,62,43,32,18,44,71,62.0,27,42,14,28,30,123,74,0,Matches,1daec722
605,Marc Cucurella,es ESP,MFDF,Getafe,es La Liga,23,1998,0.3,0,0,0,0,0,0,0,,0,0,0,0,0,0,0,0,Matches,1daec722
606,Jorge Cuenca,es ESP,DF,Getafe,es La Liga,21,1999,29.8,46,32,30,15,1,21,28,75.0,7,29,14,15,39,85,155,0,Matches,0abc51f2
607,Mickaël Cuisance,fr FRA,MF,Venezia,it Serie A,21,1999,10.2,23,9,7,12,4,10,28,35.7,18,14,0,14,12,35,5,0,Matches,5722eced
608,Mickaël Cuisance,fr FRA,MF,Bayern Munich,de Bundesliga,21,1999,0.1,1,1,0,1,0,0,0,,0,0,0,0,0,1,0,0,Matches,5722eced
609,Luke Cundle,eng ENG,MF,Wolves,eng Premier League,19,2002,2.0,4,3,0,4,0,1,1,100.0,0,0,0,0,1,5,1,0,Matches,cc3b8e78
610,Matheus Cunha,br BRA,FW,Atlético Madrid,es La Liga,22,1999,11.8,19,12,3,11,5,5,20,25.0,15,18,2,16,6,25,9,0,Matches,dc62b55d
611,Matheus Cunha,br BRA,FW,Hertha BSC,de Bundesliga,22,1999,0.7,0,0,0,0,0,0,0,,0,0,0,0,0,0,0,0,Matches,dc62b55d
612,Patrick Cutrone,it ITA,FW,Empoli,it Serie A,23,1998,15.6,5,2,0,3,2,1,9,11.1,8,11,1,10,5,10,1,0,Matches,a4fe8cda
613,Wylan Cyprien,fr FRA,MF,Nantes,fr Ligue 1,26,1995,16.6,33,17,12,18,3,13,32,40.6,19,16,6,10,10,43,14,2,Matches,3e092724
614,Rafael Czichos,de GER,DF,Köln,de Bundesliga,31,1990,15.6,29,18,18,9,2,14,28,50.0,14,23,13,10,19,48,53,2,Matches,b0a0698b
615,Lennart-Marten Czyborra,de GER,DF,Arminia,de Bundesliga,22,1999,1.5,0,0,0,0,0,0,2,0.0,2,0,0,0,3,3,3,1,Matches,7ba1f1ef
616,Danilo D'Ambrosio,it ITA,DF,Inter,it Serie A,32,1988,11.1,30,15,21,8,1,11,22,50.0,11,21,10,11,8,38,20,0,Matches,44eb9093
617,Lucas Da Cunha,fr FRA,MF,Nice,fr Ligue 1,20,2001,4.4,13,7,2,7,4,6,11,54.5,5,2,0,2,1,14,2,0,Matches,007faf7a
618,Lucas Da Cunha,fr FRA,FWMF,Clermont Foot,fr Ligue 1,20,2001,9.3,17,11,5,8,4,9,18,50.0,9,13,0,13,1,18,3,0,Matches,007faf7a
619,Damien Da Silva,fr FRA,DF,Lyon,fr Ligue 1,33,1988,12.5,13,9,7,5,1,5,9,55.6,4,15,10,5,22,35,53,1,Matches,1ec7e1c5
620,Moanes Dabbur,il ISR,FWMF,Hoffenheim,de Bundesliga,29,1992,14.6,17,9,3,5,9,4,17,23.5,13,10,0,10,5,22,4,0,Matches,eac044ad
621,Colin Dagba,fr FRA,DF,Paris S-G,fr Ligue 1,22,1998,1.8,4,2,2,2,0,3,6,50.0,3,4,2,2,2,6,1,0,Matches,29c02c9f
622,Finn Dahmen,de GER,GK,Mainz 05,de Bundesliga,23,1998,2.0,0,0,0,0,0,0,0,,0,0,0,0,0,0,2,0,Matches,dee3013b
623,Mahmoud Dahoud,de GER,MF,Dortmund,de Bundesliga,25,1996,18.4,42,19,10,24,8,20,46,43.5,26,18,3,15,17,59,16,0,Matches,db4ed67b
624,Patson Daka,zm ZAM,FW,Leicester City,eng Premier League,22,1998,12.9,15,10,2,8,5,2,19,10.5,17,7,0,7,2,17,8,0,Matches,ca45605e
625,Stuart Dallas,nir NIR,DFMF,Leeds United,eng Premier League,30,1991,32.4,93,55,58,31,4,56,105,53.3,49,45,14,31,57,150,63,2,Matches,67ca8566
626,Diogo Dalot,pt POR,DF,Manchester Utd,eng Premier League,22,1999,20.0,55,41,35,12,8,31,57,54.4,26,24,13,11,29,84,59,0,Matches,d9565625
627,Mikkel Damsgaard,dk DEN,MF,Sampdoria,it Serie A,21,2000,6.4,27,13,12,11,4,20,36,55.6,16,16,1,15,7,34,7,0,Matches,215f3907
628,Flavius Daniliuc,at AUT,DF,Nice,fr Ligue 1,20,2001,14.4,46,31,26,17,3,34,43,79.1,9,13,7,6,14,60,34,1,Matches,7ef972c3
629,Danilo,br BRA,DFMF,Juventus,it Serie A,30,1991,21.0,37,26,20,13,4,18,28,64.3,10,21,12,9,32,69,53,1,Matches,94b2001f
630,Kevin Danso,at AUT,DF,Lens,fr Ligue 1,22,1998,31.0,41,29,29,12,0,23,34,67.6,11,38,25,13,40,81,111,0,Matches,6e33125f
631,Dante,br BRA,DF,Nice,fr Ligue 1,37,1983,31.9,42,29,30,12,0,23,33,69.7,10,43,27,16,49,91,96,1,Matches,fd2bc67d
632,Ebrima Darboe,gm GAM,MF,Roma,it Serie A,20,2001,0.7,1,1,0,1,0,0,0,,0,0,0,0,1,2,0,1,Matches,cf043a33
633,Márton Dárdai,de GER,DF,Hertha BSC,de Bundesliga,19,2002,8.4,10,4,8,2,0,8,18,44.4,10,16,6,10,20,30,33,2,Matches,41bff4fa
634,Sergi Darder,es ESP,MF,Espanyol,es La Liga,27,1993,34.7,45,22,16,19,10,18,54,33.3,36,16,1,15,26,71,32,1,Matches,070a3904
635,Vladimír Darida,cz CZE,MF,Hertha BSC,de Bundesliga,30,1990,19.8,32,18,15,13,4,13,32,40.6,19,22,3,19,20,52,17,2,Matches,3eb0f2df
636,Karl Darlow,eng ENG,GK,Newcastle Utd,eng Premier League,30,1990,8.0,0,0,0,0,0,0,0,,0,0,0,0,0,0,5,1,Matches,cde3309f
637,Matteo Darmian,it ITA,DF,Inter,it Serie A,31,1989,16.7,32,16,17,9,6,16,41,39.0,25,16,1,15,19,51,25,0,Matches,96e0490d
638,Josh Dasilva,eng ENG,MFFW,Brentford,eng Premier League,22,1998,2.9,2,1,0,1,1,1,2,50.0,1,3,0,3,1,3,7,0,Matches,60344e4f
639,Jonathan David,ca CAN,FW,Lille,fr Ligue 1,21,2000,31.2,24,9,7,11,6,9,30,30.0,21,14,4,10,5,29,15,0,Matches,ce50fd99
640,Alphonso Davies,ca CAN,DF,Bayern Munich,de Bundesliga,20,2000,19.3,34,17,17,8,9,13,31,41.9,18,27,1,26,23,57,26,1,Matches,d781d855
641,Ben Davies,wls WAL,DF,Tottenham,eng Premier League,28,1993,28.2,36,21,20,12,4,13,26,50.0,13,32,19,13,30,66,75,1,Matches,44781702
642,Tom Davies,eng ENG,MF,Everton,eng Premier League,23,1998,2.6,3,1,1,1,1,2,5,40.0,3,2,1,1,2,5,9,0,Matches,9228b07c
643,Keinan Davis,eng ENG,FW,Aston Villa,eng Premier League,23,1998,0.1,0,0,0,0,0,0,0,,0,0,0,0,0,0,0,0,Matches,9deaf2c8
644,Paweł Dawidowicz,pl POL,DF,Hellas Verona,it Serie A,26,1995,13.3,30,18,16,10,4,16,25,64.0,9,14,11,3,21,51,53,0,Matches,16bb656a
645,Craig Dawson,eng ENG,DF,West Ham,eng Premier League,31,1990,30.6,29,17,20,8,1,14,25,56.0,11,59,52,7,29,58,139,0,Matches,3e9e06cb
646,Kevin De Bruyne,be BEL,MF,Manchester City,eng Premier League,30,1991,24.5,32,16,4,15,13,12,37,32.4,25,32,2,30,6,38,16,0,Matches,e46012d4
647,Konrad De La Fuente,us USA,FWMF,Marseille,fr Ligue 1,20,2001,8.7,11,7,8,2,1,7,11,63.6,4,5,0,5,2,13,4,0,Matches,4b77bb89
648,Sebastien De Maio,fr FRA,DF,Udinese,it Serie A,34,1987,2.0,5,1,4,1,0,1,9,11.1,8,6,5,1,1,6,9,0,Matches,952a03fe
649,Tommaso De Nipoti,it ITA,FW,Atalanta,it Serie A,18,2003,0.1,0,0,0,0,0,0,0,,0,0,0,0,0,0,0,0,Matches,7f9d956a
650,Rodrigo De Paul,ar ARG,MF,Atlético Madrid,es La Liga,27,1994,23.9,55,30,22,25,8,30,60,50.0,30,24,3,21,21,76,17,2,Matches,162efffd
651,Mattia De Sciglio,it ITA,DF,Juventus,it Serie A,28,1992,13.0,24,12,7,9,8,11,24,45.8,13,10,0,10,10,34,30,0,Matches,ae4e2852
652,Lorenzo De Silvestri,it ITA,DF,Bologna,it Serie A,33,1988,25.5,23,14,13,8,2,9,31,29.0,22,25,7,18,26,49,52,0,Matches,e74f0e59
653,Saulo Decarli,ch SUI,DF,Bochum,de Bundesliga,29,1992,0.1,0,0,0,0,0,0,0,,0,0,0,0,0,0,0,0,Matches,41df88b8
654,Troy Deeney,eng ENG,FW,Watford,eng Premier League,33,1988,0.3,0,0,0,0,0,0,1,0.0,1,0,0,0,0,0,2,0,Matches,82e34b69
655,Grégoire Defrel,mq MTQ,FWMF,Sassuolo,it Serie A,30,1991,15.1,15,9,4,8,3,6,16,37.5,10,11,1,10,4,19,11,0,Matches,854ee61a
656,Alessandro Deiola,it ITA,MF,Cagliari,it Serie A,25,1995,23.7,47,22,15,25,7,23,58,39.7,35,28,10,18,26,73,45,0,Matches,7f267d66
657,Romain Del Castillo,fr FRA,MFFW,Rennes,fr Ligue 1,25,1996,0.3,2,1,0,1,1,2,2,100.0,0,0,0,0,1,3,0,0,Matches,0be95d34
658,Romain Del Castillo,fr FRA,MFFW,Brest,fr Ligue 1,25,1996,10.8,27,16,3,17,7,12,31,38.7,19,12,0,12,7,34,3,0,Matches,0be95d34
659,Thomas Delaine,fr FRA,DF,Metz,fr Ligue 1,29,1992,25.7,48,35,34,12,2,22,42,52.4,20,20,7,13,27,75,31,0,Matches,8332db56
660,Thomas Delaney,dk DEN,MF,Sevilla,es La Liga,29,1991,17.2,41,24,17,21,3,16,30,53.3,14,19,10,9,13,54,35,0,Matches,fe641c1a
661,Thomas Delaney,dk DEN,MF,Dortmund,de Bundesliga,29,1991,0.2,0,0,0,0,0,0,0,,0,0,0,0,0,0,0,0,Matches,fe641c1a
662,Liam Delap,eng ENG,FW,Manchester City,eng Premier League,18,2003,0.1,0,0,0,0,0,0,0,,0,0,0,0,0,0,0,0,Matches,dd897ee7
663,Sacha Delaye,fr FRA,MF,Montpellier,fr Ligue 1,19,2002,2.9,8,6,3,2,3,2,8,25.0,6,1,0,1,1,9,1,1,Matches,e4448c8c
664,Filippo Delli Carri,it ITA,DF,Salernitana,it Serie A,22,1999,3.7,6,4,4,2,0,5,14,35.7,9,6,2,4,4,10,14,0,Matches,d2e8fd9b
665,Andy Delort,dz ALG,FW,Nice,fr Ligue 1,29,1991,27.2,15,9,3,5,7,7,12,58.3,5,13,4,9,9,24,14,0,Matches,d33c706e
666,Andy Delort,dz ALG,FW,Montpellier,fr Ligue 1,29,1991,3.0,2,0,0,1,1,0,1,0.0,1,1,0,1,0,2,4,0,Matches,d33c706e
667,Fabian Delph,eng ENG,MF,Everton,eng Premier League,31,1989,7.4,18,15,10,7,1,8,21,38.1,13,12,5,7,14,32,10,0,Matches,111c3236
668,Moussa Dembélé,fr FRA,FW,Lyon,fr Ligue 1,25,1996,24.5,18,9,5,5,8,6,15,40.0,9,13,0,13,8,26,30,1,Matches,e7986081
669,Ousmane Dembélé,fr FRA,FW,Barcelona,es La Liga,24,1997,15.7,24,16,6,10,8,7,23,30.4,16,8,0,8,8,32,3,0,Matches,b19db005
670,Yusuf Demir,at AUT,FWMF,Barcelona,es La Liga,18,2003,2.1,3,1,1,1,1,2,5,40.0,3,1,0,1,2,5,1,0,Matches,fa265f6d
671,Merih Demiral,tr TUR,DF,Atalanta,it Serie A,23,1998,21.3,31,17,18,12,1,15,28,53.6,13,26,14,12,58,89,68,1,Matches,e3cceee6
672,Kerem Demirbay,de GER,MF,Leverkusen,de Bundesliga,28,1993,22.8,52,31,19,30,3,16,41,39.0,25,32,9,23,33,85,21,0,Matches,54b4dc4e
673,Ermedin Demirović,ba BIH,FW,Freiburg,de Bundesliga,23,1998,9.7,12,6,4,4,4,1,10,10.0,9,14,1,13,1,13,7,0,Matches,ed79b7d3
674,Diego Demme,de GER,MF,Napoli,it Serie A,29,1991,7.7,21,12,4,13,4,10,21,47.6,11,11,2,9,9,30,2,0,Matches,dc3fa3b5
675,Jason Denayer,be BEL,DF,Lyon,fr Ligue 1,26,1995,11.1,11,4,8,3,0,6,7,85.7,1,8,7,1,16,27,52,0,Matches,47af88b8
676,Leander Dendoncker,be BEL,MF,Wolves,eng Premier League,26,1995,21.7,42,17,25,14,3,22,50,44.0,28,37,10,27,9,51,38,1,Matches,5a7301ae
677,Emmanuel Dennis,ng NGA,FWMF,Watford,eng Premier League,23,1997,28.7,51,35,20,22,9,17,52,32.7,35,36,2,34,15,66,13,0,Matches,2c44a35d
678,Fabio Depaoli,it ITA,DF,Hellas Verona,it Serie A,24,1997,7.8,12,7,6,4,2,1,7,14.3,6,9,2,7,8,20,14,0,Matches,d97f2e8d
679,Fabio Depaoli,it ITA,MFDF,Sampdoria,it Serie A,24,1997,1.2,3,1,1,2,0,0,2,0.0,2,2,1,1,1,4,2,0,Matches,d97f2e8d
680,Memphis Depay,nl NED,FWMF,Barcelona,es La Liga,27,1994,20.6,10,4,2,4,4,3,13,23.1,10,9,1,8,3,13,4,0,Matches,8f696594
681,Mike van der Hoorn,nl NED,DF,Arminia,de Bundesliga,28,1992,0.2,1,0,1,0,0,0,0,,0,0,0,0,1,2,2,0,Matches,25f50295
682,Arthur Desmas,fr FRA,GK,Clermont Foot,fr Ligue 1,27,1994,14.5,0,0,0,0,0,0,3,0.0,3,0,0,0,0,0,1,3,Matches,e8c5dd4d
683,Sergiño Dest,us USA,DFFW,Barcelona,es La Liga,20,2000,16.8,32,15,21,10,1,13,18,72.2,5,22,4,18,2,34,18,0,Matches,5976f83e
684,Mattia Destro,it ITA,FW,Genoa,it Serie A,30,1991,19.4,9,4,1,4,4,1,6,16.7,5,14,1,13,2,11,16,0,Matches,d7d32194
685,Gerard Deulofeu,es ESP,FWMF,Udinese,it Serie A,27,1994,29.1,11,6,2,3,6,7,29,24.1,22,14,0,14,9,20,4,0,Matches,39583cfd
686,Kiernan Dewsbury-Hall,eng ENG,MF,Leicester City,eng Premier League,22,1998,23.4,39,24,20,14,5,19,40,47.5,21,37,8,29,21,60,26,1,Matches,5c74c0f5
687,Jacopo Dezi,it ITA,MF,Venezia,it Serie A,29,1992,0.2,0,0,0,0,0,0,1,0.0,1,0,0,0,1,1,0,0,Matches,e921b9db
688,Samuel Di Carmine,it ITA,FW,Hellas Verona,it Serie A,32,1988,0.4,0,0,0,0,0,0,0,,0,0,0,0,0,0,0,0,Matches,ef94dc2f
689,Federico Di Francesco,it ITA,FWMF,Empoli,it Serie A,27,1994,15.2,16,5,2,8,6,9,23,39.1,14,17,1,16,9,25,11,0,Matches,1fca9171
690,Giovanni Di Lorenzo,it ITA,DF,Napoli,it Serie A,27,1993,31.9,58,36,30,20,8,33,58,56.9,25,28,10,18,38,96,46,1,Matches,230a2fac
691,Ángel Di María,ar ARG,FWMF,Paris S-G,fr Ligue 1,33,1988,18.3,29,18,6,13,10,14,37,37.8,23,17,0,17,6,35,3,0,Matches,19cda00b
692,Francesco Di Mariano,it ITA,FW,Venezia,it Serie A,25,1996,0.7,1,1,0,1,0,0,0,,0,2,1,1,0,1,0,0,Matches,35a2557c
693,Francesco Di Tacchio,it ITA,MF,Salernitana,it Serie A,31,1990,13.9,17,7,5,10,2,9,25,36.0,16,16,8,8,22,39,25,0,Matches,b5c3ff9f
694,Boulaye Dia,sn SEN,FW,Villarreal,es La Liga,24,1996,14.1,8,6,3,4,1,2,5,40.0,3,6,1,5,5,13,4,0,Matches,244bc2c8
695,Moussa Diaby,fr FRA,MFFW,Leverkusen,de Bundesliga,22,1999,30.7,20,11,8,9,3,5,38,13.2,33,11,0,11,8,28,2,0,Matches,aeed5c06
696,Yadaly Diaby,fr FRA,MFFW,Clermont Foot,fr Ligue 1,20,2000,0.7,0,0,0,0,0,0,1,0.0,1,0,0,0,2,2,2,0,Matches,5630a6e0
697,Mouctar Diakhaby,gn GUI,DF,Valencia,es La Liga,24,1996,21.6,35,24,18,15,2,13,23,56.5,10,29,17,12,30,65,87,3,Matches,d2110326
698,Ibrahim Diakité,gn GUI,MF,Reims,fr Ligue 1,17,2003,0.0,0,0,0,0,0,0,1,0.0,1,0,0,0,0,0,0,0,Matches,d8c19a60
699,Abdou Diallo,sn SEN,DF,Paris S-G,fr Ligue 1,25,1996,9.7,22,14,10,9,3,8,14,57.1,6,6,2,4,10,32,19,1,Matches,fc62f087
700,Habib Diallo,sn SEN,FW,Strasbourg,fr Ligue 1,26,1995,17.1,9,5,0,8,1,0,8,0.0,8,13,4,9,4,13,11,0,Matches,6605d143
701,Ibrahima Diallo,fr FRA,MF,Southampton,eng Premier League,22,1999,11.4,22,11,10,9,3,10,24,41.7,14,7,0,7,9,31,10,0,Matches,11ff3d56
702,Mouhamadou Diarra,sn SEN,MF,Strasbourg,fr Ligue 1,17,2004,1.2,2,1,1,1,0,1,1,100.0,0,0,0,0,0,2,0,0,Matches,6d0fe035
703,Stéphane Diarra,fr FRA,MFFW,Lorient,fr Ligue 1,22,1998,5.8,11,9,7,3,1,5,10,50.0,5,4,0,4,7,18,1,0,Matches,29939a1d
704,Rúben Dias,pt POR,DF,Manchester City,eng Premier League,24,1997,26.7,26,19,11,12,3,8,15,53.3,7,19,13,6,23,49,66,0,Matches,31c69ef1
705,Krepin Diatta,sn SEN,MFDF,Monaco,fr Ligue 1,22,1999,3.2,3,2,1,0,2,1,3,33.3,2,2,0,2,1,4,0,0,Matches,8104e41e
706,Amadou Diawara,gn GUI,MF,Roma,it Serie A,24,1997,1.9,7,2,5,2,0,1,3,33.3,2,2,0,2,0,7,1,0,Matches,bf309d24
707,Brahim Díaz,es ESP,MF,Milan,it Serie A,21,1999,20.6,23,17,3,11,9,8,22,36.4,14,11,0,11,8,31,4,0,Matches,407feb71
708,Javier Díaz,es ESP,GK,Sevilla,es La Liga,24,1997,1.0,0,0,0,0,0,0,0,,0,0,0,0,0,0,0,0,Matches,17a1299d
709,Luis Díaz,co COL,FW,Liverpool,eng Premier League,24,1997,10.6,9,7,3,5,1,2,8,25.0,6,7,0,7,4,13,2,0,Matches,4a1a9578
710,Víctor Díaz,es ESP,DF,Granada,es La Liga,33,1988,16.7,23,15,14,9,0,12,25,48.0,13,19,11,8,17,40,71,1,Matches,3624ce4c
711,Daniel Didavi,de GER,MFFW,Stuttgart,de Bundesliga,31,1990,3.1,6,2,0,4,2,4,7,57.1,3,4,1,3,1,7,1,0,Matches,d3096421
712,Bamba Dieng,sn SEN,FWMF,Marseille,fr Ligue 1,21,2000,10.8,17,11,5,5,7,4,14,28.6,10,7,0,7,5,22,8,0,Matches,40774c6b
713,Eric Dier,eng ENG,DF,Tottenham,eng Premier League,27,1994,34.1,15,9,6,8,1,7,14,50.0,7,37,32,5,27,42,142,1,Matches,ac861941
714,Elhadji Dieye,sn SEN,MFFW,Saint-Étienne,fr Ligue 1,19,2002,0.4,3,2,2,1,0,0,1,0.0,1,2,0,2,1,4,0,0,Matches,6a04bb7c
715,Lucas Digne,fr FRA,DF,Aston Villa,eng Premier League,28,1993,14.1,13,10,8,3,2,9,19,47.4,10,15,8,7,23,36,40,0,Matches,1b84dbe1
716,Lucas Digne,fr FRA,DF,Everton,eng Premier League,28,1993,13.0,33,19,26,4,3,21,28,75.0,7,16,5,11,14,47,30,0,Matches,1b84dbe1
717,Mitchell Dijks,nl NED,DFFW,Bologna,it Serie A,28,1993,7.7,15,6,6,6,3,5,12,41.7,7,11,2,9,3,18,10,1,Matches,0a3065c8
718,Javairô Dilrosun,nl NED,MFFW,Bordeaux,fr Ligue 1,23,1998,19.2,13,4,2,8,3,7,24,29.2,17,14,1,13,11,24,5,0,Matches,34a0f5ff
719,Javairô Dilrosun,nl NED,MF,Hertha BSC,de Bundesliga,23,1998,1.5,3,1,1,2,0,1,1,100.0,0,1,0,1,0,3,0,0,Matches,34a0f5ff
720,Federico Dimarco,it ITA,DF,Inter,it Serie A,23,1997,15.9,28,15,10,15,3,13,24,54.2,11,6,1,5,19,47,19,0,Matches,970b8574
721,Landry Dimata,be BEL,FWMF,Espanyol,es La Liga,23,1997,6.0,2,2,1,1,0,1,4,25.0,3,0,0,0,1,3,7,0,Matches,b5f63410
722,Stole Dimitrievski,mk MKD,GK,Rayo Vallecano,es La Liga,27,1993,30.8,0,0,0,0,0,0,0,,0,0,0,0,1,1,14,3,Matches,fc70e345
723,Junior Dina Ebimbe,fr FRA,MF,Paris S-G,fr Ligue 1,20,2000,3.5,9,4,3,4,2,2,3,66.7,1,5,3,2,2,11,1,0,Matches,95bb6ddc
724,Tristan Dingomé,cm CMR,MFFW,Troyes,fr Ligue 1,30,1991,12.0,23,11,10,12,1,10,18,55.6,8,7,1,6,9,32,3,0,Matches,92b56413
725,Sinaly Diomande,ci CIV,DF,Lyon,fr Ligue 1,20,2001,6.4,6,3,4,2,0,5,6,83.3,1,6,6,0,12,18,26,0,Matches,6de23ab0
726,Issa Diop,fr FRA,DF,West Ham,eng Premier League,24,1997,10.7,10,8,5,5,0,4,11,36.4,7,14,13,1,7,17,44,0,Matches,a712ca2b
727,Sofiane Diop,fr FRA,MFFW,Monaco,fr Ligue 1,21,2000,21.6,38,20,12,19,7,15,47,31.9,32,10,0,10,23,61,4,0,Matches,19053e31
728,Andy Diouf,fr FRA,MF,Rennes,fr Ligue 1,18,2003,0.2,1,1,1,0,0,1,1,100.0,0,1,0,1,0,1,0,0,Matches,9b5237b1
729,Assane Dioussé,sn SEN,MF,Saint-Étienne,fr Ligue 1,23,1997,0.3,1,1,1,0,0,1,1,100.0,0,0,0,0,0,1,0,0,Matches,7f622eef
730,Axel Disasi,fr FRA,DF,Monaco,fr Ligue 1,23,1998,30.2,42,27,20,21,1,23,39,59.0,16,40,30,10,26,68,75,0,Matches,ad82197c
731,Filippo Distefano,it ITA,FW,Fiorentina,it Serie A,17,2003,0.0,0,0,0,0,0,0,0,,0,0,0,0,0,0,0,0,Matches,2110f96c
732,Matías Dituro,ar ARG,GK,Celta Vigo,es La Liga,34,1987,38.0,0,0,0,0,0,0,0,,0,0,0,0,0,0,10,5,Matches,b6160ad0
733,Tiago Djaló,pt POR,DF,Lille,fr Ligue 1,21,2000,25.9,60,39,39,19,2,26,39,66.7,13,26,10,16,24,84,71,0,Matches,b2336681
734,Djené,tg TOG,DF,Getafe,es La Liga,29,1991,34.6,44,26,24,16,4,23,34,67.6,11,24,5,19,59,103,109,2,Matches,a4971d84
735,Moussa Djenepo,ml MLI,MF,Southampton,eng Premier League,23,1998,5.1,9,3,3,5,1,3,11,27.3,8,6,1,5,2,11,6,1,Matches,254147d4
736,Koffi Djidji,ci CIV,DF,Torino,it Serie A,28,1992,19.3,48,29,21,23,4,14,18,77.8,4,20,9,11,34,82,60,0,Matches,933d3b51
737,Alexander Djiku,gh GHA,DF,Strasbourg,fr Ligue 1,26,1994,29.9,50,37,33,13,4,18,35,51.4,17,30,13,17,61,111,90,2,Matches,43e7a164
738,Bryan Djile Nokoué,cm CMR,DFMF,Saint-Étienne,fr Ligue 1,19,2002,0.6,3,3,1,2,0,2,2,100.0,0,1,0,1,1,4,2,0,Matches,75186a6a
739,Berat Djimsiti,al ALB,DF,Atalanta,it Serie A,28,1993,25.1,43,24,21,20,2,29,46,63.0,17,21,11,10,31,74,56,0,Matches,6eee05f1
740,Ouparine Djoco,sn SEN,GK,Clermont Foot,fr Ligue 1,23,1998,23.5,0,0,0,0,0,0,0,,0,0,0,0,1,1,14,2,Matches,62124972
741,Naïs Djouahra,fr FRA,MFFW,Real Sociedad,es La Liga,21,1999,2.4,7,3,2,2,3,4,8,50.0,4,3,0,3,2,9,2,0,Matches,3594a357
742,Marko Dmitrović,rs SRB,GK,Sevilla,es La Liga,29,1992,6.0,0,0,0,0,0,0,0,,0,0,0,0,0,0,3,1,Matches,ac295d9e
743,Lewis Dobbin,eng ENG,FWMF,Everton,eng Premier League,18,2003,0.4,2,1,0,1,1,1,2,50.0,1,0,0,0,0,2,0,0,Matches,e814e1cf
744,Matt Doherty,ie IRL,DF,Tottenham,eng Premier League,29,1992,9.7,18,12,5,11,2,8,14,57.1,6,11,2,9,13,31,20,0,Matches,d557d734
745,Jeremy Doku,be BEL,MFFW,Rennes,fr Ligue 1,19,2002,5.2,10,5,3,5,2,3,6,50.0,3,4,0,4,3,13,0,0,Matches,fffea3e5
746,Kasper Dolberg,dk DEN,FW,Nice,fr Ligue 1,23,1997,16.6,9,4,4,3,2,3,9,33.3,6,15,1,14,6,15,17,0,Matches,cc83b74d
747,Jaume Doménech,es ESP,GK,Valencia,es La Liga,30,1990,3.8,0,0,0,0,0,0,0,,0,0,0,0,0,0,3,1,Matches,c9cb972b
748,Brandon Domingues,fr FRA,MFFW,Troyes,fr Ligue 1,21,2000,2.6,6,2,2,4,0,2,3,66.7,1,3,0,3,3,9,0,0,Matches,2a00c6c0
749,Carlos Dominguez,es ESP,DF,Celta Vigo,es La Liga,20,2001,3.8,4,1,4,0,0,4,6,66.7,2,2,1,1,4,8,21,0,Matches,3521abfe
750,Mario Dominguez,es ESP,FW,Valencia,es La Liga,17,2004,0.3,0,0,0,0,0,0,0,,0,0,0,0,0,0,1,0,Matches,d709cd5c
751,Nicolás Domínguez,ar ARG,MF,Bologna,it Serie A,23,1998,22.4,76,45,36,32,8,32,76,42.1,44,38,9,29,32,108,34,1,Matches,20b3a502
752,John Donald,es ESP,DF,Elche,es La Liga,20,2000,2.0,7,4,4,2,1,5,8,62.5,3,5,3,2,3,10,3,0,Matches,5e95c000
753,Lee Dongjun,kr KOR,MFFW,Hertha BSC,de Bundesliga,24,1997,1.3,2,1,0,2,0,1,3,33.3,2,2,0,2,2,4,1,0,Matches,96d0b6f0
754,Anastasios Donis,gr GRE,FWMF,Reims,fr Ligue 1,24,1996,4.1,8,7,4,2,2,2,6,33.3,4,3,0,3,0,8,1,0,Matches,0f26fd24
755,Gianluigi Donnarumma,it ITA,GK,Paris S-G,fr Ligue 1,22,1999,17.0,0,0,0,0,0,0,0,,0,0,0,0,0,0,9,2,Matches,08f5afaa
756,Niklas Dorsch,de GER,MF,Augsburg,de Bundesliga,23,1998,25.8,76,47,47,23,6,30,60,50.0,30,34,12,22,35,111,36,3,Matches,7f73bdf4
757,Gabriel Dos Santos,br BRA,DF,Arsenal,eng Premier League,23,1997,34.0,50,30,36,12,2,30,41,73.2,11,34,26,8,13,63,112,4,Matches,67ac5bb8
758,Jodel Dossou,bj BEN,MFFW,Clermont Foot,fr Ligue 1,29,1992,22.3,36,17,15,14,7,15,43,34.9,28,14,0,14,5,41,7,0,Matches,a1dbfcb1
759,Lohann Doucet,fr FRA,MFDF,Nantes,fr Ligue 1,18,2002,0.1,0,0,0,0,0,0,0,,0,0,0,0,1,1,0,0,Matches,dff0c299
760,Abdoulaye Doucouré,ml MLI,MF,Everton,eng Premier League,28,1993,28.2,75,43,30,37,8,32,71,45.1,39,33,8,25,28,103,32,0,Matches,02b29014
761,Cheick Doucouré,ml MLI,MF,Lens,fr Ligue 1,21,2000,32.7,75,43,34,34,7,36,80,45.0,44,30,7,23,68,143,24,0,Matches,ce4f40c7
762,Fodé Doucouré,ml MLI,DFFW,Reims,fr Ligue 1,20,2001,1.7,12,9,9,3,0,9,11,81.8,2,1,0,1,4,16,6,0,Matches,1bfe34dc
763,Ismaël Doukouré,fr FRA,DF,Strasbourg,fr Ligue 1,18,2003,0.2,0,0,0,0,0,0,0,,0,0,0,0,0,0,1,0,Matches,0512a60a
764,Kamory Doumbia,ml MLI,MFFW,Reims,fr Ligue 1,18,2003,3.9,8,2,2,5,1,5,13,38.5,8,9,3,6,3,11,3,0,Matches,9226aa22
765,Moussa Doumbia,ml MLI,FW,Reims,fr Ligue 1,26,1994,1.0,0,0,0,0,0,0,1,0.0,1,0,0,0,0,0,0,0,Matches,6481421d
766,Souleyman Doumbia,ci CIV,DFFW,Angers,fr Ligue 1,24,1996,24.7,30,20,16,9,5,13,27,48.1,14,25,4,21,39,69,51,0,Matches,9daeac61
767,Kieran Dowell,eng ENG,MF,Norwich City,eng Premier League,23,1997,10.1,18,7,8,7,3,9,32,28.1,23,10,1,9,7,25,4,0,Matches,2f6ec02a
768,Bartłomiej Drągowski,pl POL,GK,Fiorentina,it Serie A,23,1997,6.2,0,0,0,0,0,0,0,,0,0,0,0,1,1,5,2,Matches,085e71a7
769,Radu Drăgușin,ro ROU,DF,Sampdoria,it Serie A,19,2002,6.9,4,3,2,2,0,2,6,33.3,4,8,4,4,10,14,33,0,Matches,620922ed
770,Radu Drăgușin,ro ROU,DF,Salernitana,it Serie A,19,2002,5.4,5,4,2,3,0,4,10,40.0,6,7,3,4,13,18,17,0,Matches,620922ed
771,Cody Drameh,eng ENG,DFMF,Leeds United,eng Premier League,19,2001,1.4,4,2,3,1,0,1,3,33.3,2,0,0,0,1,5,4,0,Matches,e0d1510a
772,Julian Draxler,de GER,FWMF,Paris S-G,fr Ligue 1,27,1993,6.1,3,2,0,3,0,0,4,0.0,4,3,0,3,5,8,3,0,Matches,1a992676
773,Matthieu Dreyer,fr FRA,GK,Lorient,fr Ligue 1,32,1989,16.0,1,1,1,0,0,1,1,100.0,0,0,0,0,0,1,9,0,Matches,fbf83734
774,Domingos Duarte,pt POR,DF,Granada,es La Liga,26,1995,18.7,18,14,9,9,0,6,11,54.5,5,27,20,7,22,40,82,0,Matches,93090f69
775,Óscar Duarte,cr CRC,DF,Levante,es La Liga,32,1989,19.7,18,8,12,6,0,8,23,34.8,15,18,9,9,24,42,102,0,Matches,aa0ac32d
776,Rubén Duarte,es ESP,DF,Alavés,es La Liga,25,1995,29.1,76,47,43,27,6,43,85,50.6,42,40,6,34,57,133,82,0,Matches,1fe0492d
777,Leo Dubois,fr FRA,DF,Lyon,fr Ligue 1,26,1994,19.4,43,27,22,14,7,27,46,58.7,19,27,3,24,22,65,35,1,Matches,ff0ab48c
778,Martin Dúbravka,sk SVK,GK,Newcastle Utd,eng Premier League,32,1989,26.0,1,1,1,0,0,0,1,0.0,1,0,0,0,0,1,8,2,Matches,3a949a25
779,Ondrej Duda,sk SVK,MF,Köln,de Bundesliga,26,1994,17.9,23,16,4,12,7,6,23,26.1,17,14,2,12,17,40,9,0,Matches,79ca3e23
780,Jeremy Dudziak,tn TUN,MFFW,Greuther Fürth,de Bundesliga,25,1995,12.6,17,6,5,8,4,3,14,21.4,11,8,0,8,10,27,4,0,Matches,5a8d6540
781,Shane Duffy,ie IRL,DF,Brighton,eng Premier League,29,1992,16.0,15,12,12,3,0,8,14,57.1,6,24,18,6,16,31,76,1,Matches,7314bba4
782,Unai Dufur,es ESP,DF,Osasuna,es La Liga,22,1999,1.0,0,0,0,0,0,0,0,,0,1,0,1,4,4,4,0,Matches,c261b5dd
783,Denzel Dumfries,nl NED,DF,Inter,it Serie A,25,1996,22.5,32,12,9,14,9,16,32,50.0,16,15,6,9,9,41,26,0,Matches,481c9ece
784,Paul Dummett,wls WAL,DF,Newcastle Utd,eng Premier League,29,1991,2.2,7,3,3,4,0,5,8,62.5,3,5,0,5,3,10,5,0,Matches,3fe6bd8c
785,Alfred Duncan,gh GHA,MF,Fiorentina,it Serie A,28,1993,21.5,34,19,13,16,5,11,32,34.4,21,32,3,29,10,44,7,0,Matches,528492ea
786,Lewis Dunk,eng ENG,DF,Brighton,eng Premier League,29,1991,28.6,10,8,5,5,0,5,11,45.5,6,32,28,4,27,37,113,3,Matches,282f75f3
787,Erik Durm,de GER,DF,Eint Frankfurt,de Bundesliga,29,1992,5.3,13,7,6,5,2,10,13,76.9,3,8,1,7,10,23,7,0,Matches,cf623c78
788,Hugo Duro,es ESP,DFMF,Getafe,es La Liga,21,1999,0.1,0,0,0,0,0,0,0,,0,0,0,0,0,0,0,0,Matches,37e103f8
789,Hugo Duro,es ESP,FWMF,Valencia,es La Liga,21,1999,20.4,25,19,11,13,1,15,38,39.5,23,24,2,22,4,29,20,1,Matches,37e103f8
790,Jean-Kevin Duverne,fr FRA,DF,Brest,fr Ligue 1,24,1997,33.4,71,44,43,21,7,42,90,46.7,48,40,5,35,53,124,92,0,Matches,0cbc8baa
791,Paulo Dybala,ar ARG,FWMF,Juventus,it Serie A,27,1993,22.9,30,13,7,14,9,8,35,22.9,27,19,0,19,9,39,4,3,Matches,e0921a4f
792,Edin Džeko,ba BIH,FW,Inter,it Serie A,35,1986,27.4,14,8,7,4,3,8,25,32.0,17,22,5,17,4,18,35,0,Matches,3bb7f478
793,Enzo Ebosse,cm CMR,DF,Angers,fr Ligue 1,22,1999,21.0,25,14,19,6,0,11,19,57.9,8,19,9,10,15,40,42,0,Matches,9ba7b4fa
794,Tyronne Ebuehi,ng NGA,DF,Venezia,it Serie A,25,1995,12.6,28,12,16,8,4,10,18,55.6,8,13,3,10,16,44,38,1,Matches,6af30900
795,Ederson,br BRA,GK,Manchester City,eng Premier League,27,1993,37.0,2,1,2,0,0,0,2,0.0,2,0,0,0,0,2,12,0,Matches,3bb7b8b4
796,Éderson,br BRA,MF,Salernitana,it Serie A,22,1999,12.7,29,18,11,14,4,14,26,53.8,12,11,2,9,19,48,8,0,Matches,a9202def
797,Odsonne Édouard,fr FRA,FWMF,Crystal Palace,eng Premier League,23,1998,17.4,16,10,2,7,7,7,21,33.3,14,20,5,15,0,16,18,0,Matches,0562b7f1
798,CJ Egan-Riley,eng ENG,DF,Manchester City,eng Premier League,18,2003,0.0,1,1,1,0,0,1,1,100.0,0,0,0,0,0,1,0,0,Matches,d313e8ff
799,Maximilian Eggestein,de GER,MF,Freiburg,de Bundesliga,24,1996,24.4,48,28,17,25,6,22,50,44.0,28,35,11,24,30,78,32,1,Matches,beb882a8
800,Lilian Egloff,de GER,MFDF,Stuttgart,de Bundesliga,18,2002,0.3,1,0,0,1,0,0,0,,0,1,0,1,0,1,0,0,Matches,2f7fec15
801,Kingsley Ehizibue,nl NED,DF,Köln,de Bundesliga,26,1995,7.6,32,18,27,5,0,15,24,62.5,9,13,4,9,9,41,26,0,Matches,76b2817e
802,Julian Eitschberger,de GER,DF,Hertha BSC,de Bundesliga,17,2004,0.5,0,0,0,0,0,0,1,0.0,1,1,1,0,2,2,2,0,Matches,943b9602
803,Albin Ekdal,se SWE,MF,Sampdoria,it Serie A,32,1989,18.2,43,28,17,21,5,26,56,46.4,30,27,7,20,29,72,25,0,Matches,f503ea63
804,Hugo Ekitike,fr FRA,FWMF,Reims,fr Ligue 1,19,2002,14.1,18,10,8,6,4,4,11,36.4,7,9,2,7,6,24,15,0,Matches,5b92d896
805,Jurgen Ekkelenkamp,nl NED,MFFW,Hertha BSC,de Bundesliga,21,2000,8.0,8,3,2,6,0,2,7,28.6,5,9,2,7,4,12,5,0,Matches,73d6a176
806,Caleb Ekuban,gh GHA,FWMF,Genoa,it Serie A,27,1994,19.1,19,12,2,12,5,7,23,30.4,16,19,5,14,9,28,6,0,Matches,7afbd2c3
807,Anthony Elanga,se SWE,MFFW,Manchester Utd,eng Premier League,19,2002,13.5,26,20,12,12,2,15,29,51.7,14,17,1,16,9,35,7,0,Matches,2fba6108
808,Alberth Elis,hn HON,MFFW,Bordeaux,fr Ligue 1,25,1996,15.7,19,10,5,5,9,11,25,44.0,14,9,0,9,7,26,10,0,Matches,104b4ad3
809,Harvey Elliott,eng ENG,MF,Liverpool,eng Premier League,18,2003,3.8,3,0,1,1,1,0,6,0.0,6,8,1,7,4,7,2,0,Matches,c8387671
810,Elif Elmas,mk MKD,MFFW,Napoli,it Serie A,21,1999,18.0,25,15,10,10,5,12,28,42.9,16,13,2,11,8,33,17,0,Matches,cf007308
811,Mohamed Elneny,eg EGY,MF,Arsenal,eng Premier League,29,1992,9.0,16,8,10,5,1,7,12,58.3,5,7,1,6,14,30,13,0,Matches,47a34c4f
812,Aritz Elustondo,es ESP,DF,Real Sociedad,es La Liga,27,1994,23.4,21,14,16,5,0,10,20,50.0,10,19,13,6,29,50,86,0,Matches,f7dc2ae5
813,Nico Elvedi,ch SUI,DF,M'Gladbach,de Bundesliga,24,1996,27.0,40,24,23,17,0,22,36,61.1,14,33,22,11,34,74,83,1,Matches,48035304
814,Sepe Elye Wahi,fr FRA,FWMF,Montpellier,fr Ligue 1,18,2003,19.8,18,10,9,6,3,6,16,37.5,10,7,0,7,4,22,4,0,Matches,0d7b6576
815,Mohamed Elyounoussi,no NOR,MFFW,Southampton,eng Premier League,26,1994,22.7,36,17,14,15,7,11,39,28.2,28,23,2,21,12,48,28,0,Matches,68dc0dac
816,Adri Embarba,es ESP,MFFW,Espanyol,es La Liga,29,1992,22.1,44,29,22,15,7,26,69,37.7,43,35,3,32,19,63,30,0,Matches,db8f0eba
817,Breel Embolo,ch SUI,FWMF,M'Gladbach,de Bundesliga,24,1997,24.1,17,11,2,12,3,4,9,44.4,5,14,2,12,6,23,8,0,Matches,0b4f388a
818,Emerson,br BRA,DFMF,Tottenham,eng Premier League,22,1999,25.4,72,47,50,16,6,36,67,53.7,31,25,2,23,22,94,92,1,Matches,df8b52a5
819,Emerson,br BRA,DF,Barcelona,es La Liga,22,1999,1.0,3,3,2,1,0,1,2,50.0,1,1,0,1,2,5,1,0,Matches,df8b52a5
820,Renaud Emond,be BEL,MFFW,Nantes,fr Ligue 1,29,1991,2.1,1,0,0,1,0,0,4,0.0,4,2,1,1,0,1,1,0,Matches,5c9ac7f0
821,Youssef En-Nesyri,ma MAR,FW,Sevilla,es La Liga,24,1997,14.2,10,5,5,2,3,4,11,36.4,7,9,1,8,4,14,18,0,Matches,04e17fd5
822,Keita Endo,jp JPN,MF,Union Berlin,de Bundesliga,23,1997,0.6,1,1,1,0,0,0,0,,0,1,0,1,0,1,0,0,Matches,1a83027b
823,Wataru Endo,jp JPN,MF,Stuttgart,de Bundesliga,28,1993,32.2,73,41,34,34,5,31,72,43.1,41,43,12,31,30,103,64,0,Matches,c149016b
824,Christian Eriksen,dk DEN,MF,Brentford,eng Premier League,29,1992,10.4,13,6,4,5,4,8,17,47.1,9,9,1,8,9,22,14,0,Matches,980522ec
825,Martin Erlic,hr CRO,DF,Spezia,it Serie A,23,1998,28.6,28,16,18,10,0,10,18,55.6,8,54,39,15,28,56,122,1,Matches,0fee6bda
826,Gonzalo Escalante,ar ARG,MF,Lazio,it Serie A,28,1993,0.1,1,0,1,0,0,1,1,100.0,0,2,1,1,1,2,0,0,Matches,3f79a1c8
827,Gonzalo Escalante,ar ARG,MF,Alavés,es La Liga,28,1993,14.4,30,14,9,20,1,13,34,38.2,21,27,2,25,21,51,28,0,Matches,3f79a1c8
828,Aarón Escandell,es ESP,GK,Granada,es La Liga,25,1995,3.2,0,0,0,0,0,0,1,0.0,1,0,0,0,0,0,4,0,Matches,67669ce7
829,Sergio Escudero,es ESP,DFMF,Granada,es La Liga,31,1989,15.9,46,24,25,17,4,26,54,48.1,28,18,3,15,26,72,35,0,Matches,b0616e3d
830,Alfonso Espino,uy URU,DF,Cádiz,es La Liga,29,1992,37.0,107,63,58,39,10,44,112,39.3,68,45,10,35,54,161,87,1,Matches,db001fa9
831,Michael Esser,de GER,GK,Bochum,de Bundesliga,33,1987,3.0,0,0,0,0,0,0,1,0.0,1,0,0,0,0,0,2,0,Matches,83e0eeb4
832,Estanis,es ESP,FW,Barcelona,es La Liga,17,2003,0.1,1,1,0,1,0,1,1,100.0,0,0,0,0,0,1,0,0,Matches,ace50e9f
833,Maxime Estève,fr FRA,DF,Montpellier,fr Ligue 1,19,2002,20.6,27,18,22,4,1,15,27,55.6,12,31,24,7,22,49,69,1,Matches,1a066e69
834,Pervis Estupiñán,ec ECU,DF,Villarreal,es La Liga,23,1998,17.5,36,22,20,11,5,17,24,70.8,7,13,5,8,25,61,29,2,Matches,d38fdf53
835,Oghenekaro Etebo,ng NGA,MF,Watford,eng Premier League,25,1995,4.5,11,8,7,4,0,3,8,37.5,5,3,1,2,5,16,5,0,Matches,b579e83d
836,Jonny Evans,nir NIR,DF,Leicester City,eng Premier League,33,1988,15.0,24,14,14,8,2,14,22,63.6,8,17,13,4,20,44,59,0,Matches,f8fcd2a5
837,Eberechi Eze,eng ENG,MFFW,Crystal Palace,eng Premier League,23,1998,6.7,10,6,5,2,3,6,11,54.5,5,4,1,3,5,15,1,0,Matches,ae4fc6a4
838,Abdessamad Ezzalzouli,ma MAR,FW,Barcelona,es La Liga,19,2001,6.4,17,9,9,5,3,5,8,62.5,3,3,0,3,9,26,0,0,Matches,bed68338
839,Łukasz Fabiański,pl POL,GK,West Ham,eng Premier League,36,1985,37.0,0,0,0,0,0,0,0,,0,0,0,0,0,0,11,0,Matches,9328b835
840,Fabinho,br BRA,MF,Liverpool,eng Premier League,27,1993,25.7,46,25,17,23,6,24,70,34.3,46,33,10,23,39,85,25,1,Matches,7f3b388c
841,Fábio,br BRA,DF,Nantes,fr Ligue 1,31,1990,18.5,61,40,31,23,7,36,74,48.6,38,29,7,22,35,96,31,1,Matches,bc7b4580
842,Cesc Fàbregas,es ESP,MF,Monaco,fr Ligue 1,34,1987,0.4,1,0,0,1,0,1,1,100.0,0,0,0,0,1,2,0,0,Matches,33508c78
843,Wout Faes,be BEL,DF,Reims,fr Ligue 1,23,1998,37.0,40,24,30,9,1,25,33,75.8,8,47,37,10,53,93,169,2,Matches,9c221d14
844,Wahidullah Faghir,dk DEN,FW,Stuttgart,de Bundesliga,18,2003,1.4,0,0,0,0,0,0,1,0.0,1,2,0,2,0,0,0,0,Matches,93c9e7d9
845,Romain Faivre,fr FRA,MF,Lyon,fr Ligue 1,23,1998,9.9,10,4,2,6,2,4,13,30.8,9,4,0,4,3,13,2,0,Matches,745ca0a3
846,Romain Faivre,fr FRA,MF,Brest,fr Ligue 1,23,1998,19.9,30,18,12,13,5,12,30,40.0,18,11,0,11,13,43,10,0,Matches,745ca0a3
847,Radamel Falcao,co COL,FW,Rayo Vallecano,es La Liga,35,1986,9.3,2,1,0,1,1,1,4,25.0,3,4,1,3,2,4,11,0,Matches,66116290
848,Diego Falcinelli,it ITA,FW,Bologna,it Serie A,30,1991,0.7,2,2,2,0,0,0,0,,0,0,0,0,1,3,1,0,Matches,a39b9ef6
849,Wladimiro Falcone,it ITA,GK,Sampdoria,it Serie A,26,1995,9.5,0,0,0,0,0,0,0,,0,0,0,0,1,1,5,0,Matches,9f5a610b
850,Fali,es ESP,DFMF,Cádiz,es La Liga,27,1993,20.0,32,19,24,8,0,17,32,53.1,15,26,16,10,24,56,82,0,Matches,72a84002
851,Paolo Faragò,it ITA,MF,Cagliari,it Serie A,28,1993,0.2,1,1,1,0,0,0,0,,0,2,0,2,0,1,0,0,Matches,9085dd7c
852,Omar Faraj,se SWE,FW,Levante,es La Liga,19,2002,0.0,1,0,1,0,0,1,1,100.0,0,0,0,0,0,1,0,0,Matches,de627c8a
853,Davide Faraoni,it ITA,DF,Hellas Verona,it Serie A,29,1991,28.6,62,40,38,21,3,29,62,46.8,33,38,5,33,23,85,62,1,Matches,aae9d04a
854,Mohamed Fares,dz ALG,DFMF,Genoa,it Serie A,25,1996,6.5,4,2,1,3,0,0,4,0.0,4,8,3,5,8,12,11,0,Matches,b7a5bc86
855,Diego Farias,br BRA,MFFW,Cagliari,it Serie A,31,1990,0.7,1,1,0,1,0,1,3,33.3,2,0,0,0,0,1,0,0,Matches,157d29b6
856,Wuilker Faríñez,ve VEN,GK,Lens,fr Ligue 1,23,1998,12.3,0,0,0,0,0,0,0,,0,0,0,0,0,0,4,0,Matches,2c127b6f
857,Ömer Faruk Beyaz,tr TUR,DFMF,Stuttgart,de Bundesliga,17,2003,0.8,4,3,1,3,0,1,5,20.0,4,0,0,0,2,6,0,0,Matches,8307b663
858,Noah Fatar,fr FRA,DFMF,Angers,fr Ligue 1,19,2002,0.1,1,0,0,0,1,0,1,0.0,1,0,0,0,1,2,0,0,Matches,2693f6bc
859,Ansu Fati,es ESP,FWMF,Barcelona,es La Liga,18,2002,3.7,3,2,0,2,1,1,1,100.0,0,4,0,4,1,4,0,0,Matches,0ba976e4
860,Julien Faussurier,fr FRA,MFDF,Brest,fr Ligue 1,34,1987,5.4,10,6,3,3,4,6,13,46.2,7,12,1,11,5,15,6,0,Matches,767212e6
861,Andrea Favilli,it ITA,FW,Genoa,it Serie A,24,1997,0.4,1,1,0,0,1,0,0,,0,0,0,0,0,1,2,0,Matches,44510fde
862,Federico Fazio,ar ARG,DF,Salernitana,it Serie A,34,1987,15.9,17,11,10,6,1,9,12,75.0,3,21,16,5,27,44,67,1,Matches,4e358a2d
863,Aleix Febas,es ESP,MF,Mallorca,es La Liga,25,1996,1.3,4,1,0,4,0,2,4,50.0,2,0,0,0,0,4,0,0,Matches,38126309
864,Adrian Fein,de GER,MF,Greuther Fürth,de Bundesliga,22,1999,0.4,0,0,0,0,0,0,1,0.0,1,0,0,0,2,2,0,0,Matches,60097ff6
865,Nabil Fekir,fr FRA,MF,Betis,es La Liga,28,1993,31.0,43,29,5,25,13,7,36,19.4,29,14,0,14,7,50,7,0,Matches,bece776f
866,Felipe,br BRA,DF,Atlético Madrid,es La Liga,32,1989,16.7,20,15,11,8,1,8,18,44.4,10,17,11,6,28,48,77,0,Matches,51a3c4c8
867,Luiz Felipe,it ITA,DF,Lazio,it Serie A,24,1997,27.7,41,23,21,16,4,20,34,58.8,14,40,33,7,33,74,102,1,Matches,15d0c248
868,João Félix,pt POR,FWMF,Atlético Madrid,es La Liga,21,1999,14.0,5,2,1,4,0,1,5,20.0,4,4,1,3,7,12,8,0,Matches,8aafd64f
869,Ohis Felix Uduokhai,de GER,DF,Augsburg,de Bundesliga,23,1997,8.7,9,6,6,3,0,6,11,54.5,5,13,8,5,9,18,33,0,Matches,677da306
870,Kiko Femenía,es ESP,DF,Watford,eng Premier League,30,1991,23.8,35,22,23,10,2,21,37,56.8,16,24,8,16,37,72,51,0,Matches,e5d01ecf
871,Evan Ferguson,ie IRL,MF,Brighton,eng Premier League,16,2004,0.3,0,0,0,0,0,0,0,,0,0,0,0,0,0,0,0,Matches,4596da74
872,Nathan Ferguson,eng ENG,DF,Crystal Palace,eng Premier League,20,2000,0.1,0,0,0,0,0,0,0,,0,0,0,0,0,0,0,0,Matches,2f8d27bc
873,Bruno Fernandes,pt POR,MF,Manchester Utd,eng Premier League,26,1994,34.6,54,28,26,22,6,26,91,28.6,65,36,0,36,17,71,42,2,Matches,507c7bdf
874,Edimilson Fernandes,ch SUI,MFDF,Arminia,de Bundesliga,25,1996,3.1,2,0,1,1,0,1,4,25.0,3,2,2,0,2,4,6,0,Matches,3bb625ac
875,Aitor Fernández,es ESP,GK,Levante,es La Liga,30,1991,13.0,2,1,2,0,0,2,2,100.0,0,0,0,0,0,2,7,0,Matches,a01c3d54
876,Álex Fernández,es ESP,MF,Cádiz,es La Liga,28,1992,22.8,47,31,22,17,8,21,61,34.4,40,30,7,23,30,77,31,0,Matches,aa677a35
877,Álvaro Fernández,es ESP,GK,Brentford,eng Premier League,23,1998,12.0,0,0,0,0,0,0,0,,0,0,0,0,0,0,5,2,Matches,f127d782
878,Federico Fernández,ar ARG,DF,Newcastle Utd,eng Premier League,32,1989,5.8,3,0,3,0,0,2,5,40.0,3,10,10,0,4,7,28,0,Matches,f25b010f
879,Fernandinho,br BRA,MFDF,Manchester City,eng Premier League,36,1985,10.7,21,10,7,10,4,9,27,33.3,18,8,2,6,8,29,13,1,Matches,101da2b5
880,Fernando,br BRA,MFDF,Sevilla,es La Liga,34,1987,20.6,24,17,14,9,1,12,33,36.4,21,21,13,8,29,53,32,2,Matches,41f32541
881,Alex Ferrari,it ITA,DF,Sampdoria,it Serie A,27,1994,18.3,40,22,28,9,3,19,33,57.6,14,31,22,9,39,79,63,1,Matches,d0dbca9f
882,Salvador Ferrer,es ESP,DFMF,Spezia,it Serie A,23,1998,16.6,32,18,15,9,8,12,25,48.0,13,24,12,12,18,50,46,0,Matches,eb76987d
883,Jordan Ferri,fr FRA,MF,Montpellier,fr Ligue 1,29,1992,32.3,55,35,28,23,4,29,87,33.3,58,21,5,16,30,85,35,0,Matches,375622c5
884,Riccardo Fiamozzi,it ITA,DF,Empoli,it Serie A,28,1993,6.9,7,5,2,2,3,2,4,50.0,2,6,5,1,7,14,12,0,Matches,9f9b9269
885,Fidel,es ESP,MF,Elche,es La Liga,31,1989,25.1,44,23,18,17,9,14,57,24.6,43,9,1,8,7,51,20,0,Matches,eb82b6f1
886,Karol Fila,pl POL,DF,Strasbourg,fr Ligue 1,23,1998,6.2,10,8,5,4,1,4,8,50.0,4,7,2,5,4,14,6,0,Matches,50ac8941
887,Alfreð Finnbogason,is ISL,FW,Augsburg,de Bundesliga,32,1989,3.2,3,1,0,2,1,2,4,50.0,2,5,1,4,2,5,8,0,Matches,f9e7c4ac
888,Luca Fiordilino,it ITA,MF,Venezia,it Serie A,25,1996,7.3,21,13,11,6,4,13,27,48.1,14,14,4,10,11,32,12,0,Matches,9bb1ad91
889,Vincenzo Fiorillo,it ITA,GK,Salernitana,it Serie A,31,1990,1.0,0,0,0,0,0,0,0,,0,0,0,0,0,0,1,0,Matches,a2565f79
890,Roberto Firmino,br BRA,FW,Liverpool,eng Premier League,29,1991,11.0,23,14,5,8,10,3,16,18.8,13,20,0,20,4,27,3,0,Matches,4c370d81
891,Junior Firpo,es ESP,DFMF,Leeds United,eng Premier League,24,1996,19.0,60,28,29,26,5,31,59,52.5,28,22,6,16,24,84,38,0,Matches,24f59bb2
892,Mark Flekken,nl NED,GK,Freiburg,de Bundesliga,28,1993,32.0,0,0,0,0,0,0,2,0.0,2,1,0,1,2,2,10,1,Matches,a92ab7be
893,Ashley Fletcher,eng ENG,FW,Watford,eng Premier League,25,1995,0.3,2,1,1,1,0,1,1,100.0,0,1,1,0,0,2,0,0,Matches,eeb6551f
894,Alexis Flips,fr FRA,MFDF,Reims,fr Ligue 1,21,2000,11.7,37,21,21,9,7,22,45,48.9,23,21,0,21,24,61,17,0,Matches,caef7840
895,Alessandro Florenzi,it ITA,DFMF,Milan,it Serie A,30,1991,12.8,28,14,14,7,7,14,32,43.8,18,9,2,7,27,55,10,1,Matches,e288d4b3
896,Phil Foden,eng ENG,FWMF,Manchester City,eng Premier League,21,2000,23.6,16,8,10,4,2,7,17,41.2,10,9,0,9,11,27,5,0,Matches,ed1e53f3
897,Mamadou Fofana,ml MLI,DF,Metz,fr Ligue 1,23,1998,0.4,1,1,0,1,0,1,2,50.0,1,2,1,1,1,2,2,0,Matches,4c4ffacc
898,Seko Fofana,ci CIV,MF,Lens,fr Ligue 1,26,1995,37.3,27,19,11,13,3,12,58,20.7,46,24,2,22,26,53,17,1,Matches,5313ed43
899,Wesley Fofana,fr FRA,DF,Leicester City,eng Premier League,20,2000,7.0,12,8,11,1,0,7,11,63.6,4,5,2,3,12,24,26,1,Matches,132a82f1
900,Youssouf Fofana,fr FRA,MF,Monaco,fr Ligue 1,22,1999,24.3,69,43,19,41,9,29,56,51.8,27,29,7,22,32,101,22,2,Matches,822d51d7
901,Thomas Foket,be BEL,DFFW,Reims,fr Ligue 1,26,1994,24.8,28,19,12,13,3,18,40,45.0,22,26,4,22,33,61,35,0,Matches,90eb507d
902,Thomas Fontaine,mg MAD,DF,Lorient,fr Ligue 1,30,1991,1.9,2,0,1,0,1,0,1,0.0,1,3,3,0,2,4,4,0,Matches,9f90c06b
903,José Fontán,es ESP,DF,Celta Vigo,es La Liga,21,2000,3.1,5,3,3,2,0,1,5,20.0,4,3,1,2,10,15,10,0,Matches,1827a42d
904,José Fonte,pt POR,DF,Lille,fr Ligue 1,37,1983,38.0,23,12,14,7,2,11,25,44.0,14,39,32,7,44,67,159,1,Matches,90f87966
905,Fernando Forestieri,it ITA,FWMF,Udinese,it Serie A,31,1990,0.6,0,0,0,0,0,0,1,0.0,1,1,0,1,0,0,1,0,Matches,d60c26fc
906,Pablo Fornals,es ESP,MF,West Ham,eng Premier League,25,1996,31.1,54,28,21,21,12,22,84,26.2,62,49,2,47,27,81,16,1,Matches,82927de4
907,Emil Forsberg,se SWE,MF,RB Leipzig,de Bundesliga,29,1991,19.0,21,12,2,11,8,7,22,31.8,15,18,0,18,2,23,2,1,Matches,9a2e0ccc
908,Adam Forshaw,eng ENG,MF,Leeds United,eng Premier League,29,1991,17.0,53,23,21,27,5,21,54,38.9,33,17,1,16,19,72,12,2,Matches,9f1938ab
909,Marcus Forss,fi FIN,FWMF,Brentford,eng Premier League,22,1999,2.3,3,3,0,2,1,2,4,50.0,2,5,0,5,1,4,0,0,Matches,82c215a0
910,Fraser Forster,eng ENG,GK,Southampton,eng Premier League,33,1988,19.0,1,0,1,0,0,0,1,0.0,1,0,0,0,0,1,23,2,Matches,c3e39f12
911,Philipp Förster,de GER,MFFW,Stuttgart,de Bundesliga,26,1995,10.7,20,13,4,12,4,11,26,42.3,15,12,1,11,3,23,2,0,Matches,76fa965f
912,Francesco Forte,it ITA,FW,Venezia,it Serie A,28,1993,4.7,3,2,0,2,1,2,5,40.0,3,1,0,1,0,3,2,0,Matches,69e11a01
913,Steven Fortes,cv CPV,DF,Lens,fr Ligue 1,29,1992,1.0,2,0,2,0,0,1,2,50.0,1,2,1,1,0,2,4,0,Matches,574aa9ec
914,Ben Foster,eng ENG,GK,Watford,eng Premier League,38,1983,26.0,0,0,0,0,0,0,3,0.0,3,0,0,0,0,0,9,4,Matches,d0b3ceb9
915,Tariqe Fosu,gh GHA,DF,Brentford,eng Premier League,25,1995,0.2,0,0,0,0,0,0,0,,0,1,0,1,0,0,0,0,Matches,3dcef539
916,Timothy Fosu-Mensah,nl NED,DF,Leverkusen,de Bundesliga,23,1998,1.6,5,3,3,1,1,4,4,100.0,0,1,0,1,2,7,2,0,Matches,a9142dc3
917,Dimitri Foulquier,fr FRA,DF,Granada,es La Liga,28,1993,2.0,0,0,0,0,0,0,1,0.0,1,2,1,1,1,1,2,0,Matches,45e17712
918,Dimitri Foulquier,fr FRA,DF,Valencia,es La Liga,28,1993,26.0,36,17,17,15,4,21,34,61.8,13,19,3,16,29,65,49,0,Matches,45e17712
919,Juan Foyth,ar ARG,DF,Villarreal,es La Liga,23,1998,21.4,69,49,35,28,6,35,47,74.5,12,29,7,22,20,89,50,0,Matches,6c7762c3
920,Gianluca Frabotta,it ITA,DFMF,Hellas Verona,it Serie A,22,1999,0.2,0,0,0,0,0,0,1,0.0,1,1,0,1,1,1,0,0,Matches,d80b1835
921,Raphael Framberger,de GER,DF,Augsburg,de Bundesliga,25,1995,9.4,26,19,12,10,4,13,27,48.1,14,8,2,6,9,35,25,0,Matches,626fab5f
922,Przemysław Frankowski,pl POL,DF,Lens,fr Ligue 1,26,1995,27.2,57,39,22,27,8,36,74,48.6,38,27,0,27,28,85,52,0,Matches,00a8d210
923,Enric Franquesa,es ESP,DFFW,Levante,es La Liga,24,1997,6.9,5,3,4,0,1,0,1,0.0,1,4,0,4,7,12,11,0,Matches,40883e3a
924,Fransérgio,br BRA,MF,Bordeaux,fr Ligue 1,30,1990,14.0,24,10,8,12,4,12,43,27.9,31,18,6,12,23,47,23,0,Matches,deba6b05
925,Ryan Fraser,sct SCO,FWMF,Newcastle Utd,eng Premier League,27,1994,16.3,10,3,5,3,2,5,13,38.5,8,11,1,10,11,21,11,0,Matches,d56543a0
926,Davide Frattesi,it ITA,MF,Sassuolo,it Serie A,21,1999,31.7,46,16,26,18,2,26,52,50.0,26,44,12,32,29,75,62,1,Matches,2a7d27c1
927,Fred,br BRA,MF,Manchester Utd,eng Premier League,28,1993,22.5,63,27,32,24,7,22,79,27.8,57,38,11,27,32,95,24,0,Matches,b853e0ad
928,Ryan Fredericks,eng ENG,DF,West Ham,eng Premier League,28,1992,3.4,2,2,2,0,0,0,1,0.0,1,2,1,1,4,6,6,0,Matches,c067631c
929,Morten Frendrup,dk DEN,DFMF,Genoa,it Serie A,20,2001,7.7,40,24,19,13,8,13,29,44.8,16,19,2,17,17,57,7,1,Matches,f4d60499
930,Remo Freuler,ch SUI,MF,Atalanta,it Serie A,29,1992,26.3,69,39,22,33,14,30,70,42.9,40,48,8,40,35,104,26,1,Matches,98d2c2c4
931,Marvin Friedrich,de GER,DF,M'Gladbach,de Bundesliga,25,1995,6.7,14,8,10,4,0,9,11,81.8,2,5,3,2,5,19,26,0,Matches,b77f44a4
932,Marvin Friedrich,de GER,DF,Union Berlin,de Bundesliga,25,1995,13.0,17,5,14,3,0,10,16,62.5,6,13,7,6,23,40,47,0,Matches,b77f44a4
933,Jeremie Frimpong,nl NED,DF,Leverkusen,de Bundesliga,20,2000,22.8,32,18,19,12,1,12,23,52.2,11,24,6,18,17,49,40,2,Matches,74f2e748
934,Christian Früchtl,de GER,GK,Bayern Munich,de Bundesliga,21,2000,0.1,0,0,0,0,0,0,0,,0,0,0,0,0,0,0,0,Matches,1940be91
935,Jorge de Frutos,es ESP,MFFW,Levante,es La Liga,24,1997,19.6,33,15,14,11,8,10,51,19.6,41,11,1,10,12,45,13,0,Matches,38ce1150
936,Leo Fuhr Hjelde,no NOR,MFDF,Leeds United,eng Premier League,17,2003,1.7,5,4,3,2,0,3,3,100.0,0,3,3,0,4,9,7,0,Matches,d102b8a2
937,Chris Führich,de GER,MFFW,Stuttgart,de Bundesliga,23,1998,19.0,28,16,10,10,8,18,39,46.2,21,31,2,29,8,36,9,0,Matches,0cf778df
938,Angelo Fulgini,fr FRA,MFFW,Angers,fr Ligue 1,24,1996,32.5,35,25,8,18,9,14,44,31.8,30,21,5,16,22,57,5,1,Matches,4b96c347
939,Marius Funk,de GER,GK,Greuther Fürth,de Bundesliga,25,1996,8.0,0,0,0,0,0,0,0,,0,0,0,0,0,0,8,1,Matches,86314793
940,Stephan Fürstner,de GER,MF,Mainz 05,de Bundesliga,33,1987,0.1,0,0,0,0,0,0,2,0.0,2,0,0,0,0,0,1,0,Matches,18c2e247
941,Matteo Gabbia,it ITA,DF,Milan,it Serie A,21,1999,6.0,4,3,1,3,0,0,4,0.0,4,2,2,0,8,12,12,0,Matches,c235e803
942,Manolo Gabbiadini,it ITA,FWMF,Sampdoria,it Serie A,29,1991,12.7,6,4,3,2,1,1,7,14.3,6,5,2,3,3,9,10,0,Matches,8f866fe8
943,Mijat Gaćinović,rs SRB,MF,Hoffenheim,de Bundesliga,26,1995,1.2,3,3,1,1,1,3,3,100.0,0,1,0,1,1,4,2,0,Matches,16daec92
944,Gianluca Gaetano,it ITA,MF,Napoli,it Serie A,21,2000,0.2,1,1,1,0,0,1,2,50.0,1,0,0,0,2,3,0,0,Matches,3b387cc7
945,Luca Gagliano,it ITA,FWDF,Cagliari,it Serie A,21,2000,0.1,0,0,0,0,0,0,0,,0,1,0,1,0,0,1,0,Matches,1d00a56c
946,Roberto Gagliardini,it ITA,MF,Inter,it Serie A,27,1994,7.2,12,6,7,4,1,1,13,7.7,12,14,5,9,9,21,7,0,Matches,ce30bfc8
947,Riccardo Gagliolo,se SWE,DF,Salernitana,it Serie A,31,1990,12.6,23,12,16,4,3,16,27,59.3,11,15,8,7,28,51,52,0,Matches,173061c0
948,Javi Galán,es ESP,DF,Celta Vigo,es La Liga,26,1994,36.6,108,66,60,37,11,42,99,42.4,57,48,8,40,45,153,52,0,Matches,a4b00319
949,Iñigo Ruiz de Galarreta,es ESP,MF,Mallorca,es La Liga,27,1993,15.3,40,21,14,21,5,14,30,46.7,16,16,2,14,20,60,21,0,Matches,91f7631f
950,Nicolas Galazzi,it ITA,MF,Venezia,it Serie A,20,2000,0.2,2,1,1,0,1,0,1,0.0,1,0,0,0,0,2,0,0,Matches,a796492f
951,Pablo Galdames Millán,cl CHI,MF,Genoa,it Serie A,24,1996,11.4,28,12,6,16,6,12,35,34.3,23,16,2,14,8,36,9,1,Matches,dd403465
952,Thiago Galhardo,br BRA,FWMF,Celta Vigo,es La Liga,32,1989,12.8,12,6,3,3,6,2,12,16.7,10,15,2,13,6,18,9,0,Matches,766f48dd
953,Conor Gallagher,eng ENG,MF,Crystal Palace,eng Premier League,21,2000,31.6,68,37,34,20,14,21,69,30.4,48,58,9,49,29,97,26,0,Matches,c2731c10
954,Gauthier Gallon,fr FRA,GK,Troyes,fr Ligue 1,28,1993,31.0,3,0,3,0,0,1,1,100.0,0,0,0,0,2,5,12,1,Matches,db3164e1
955,Cristian Gamboa,cr CRC,DF,Bochum,de Bundesliga,31,1989,19.1,59,36,40,16,3,30,61,49.2,31,22,7,15,32,91,35,1,Matches,f27680d9
956,Kévin Gameiro,fr FRA,FW,Strasbourg,fr Ligue 1,34,1987,26.5,19,10,5,9,5,6,18,33.3,12,22,1,21,6,25,1,0,Matches,42276181
957,Idrissa Gana Gueye,sn SEN,MF,Paris S-G,fr Ligue 1,31,1989,18.2,60,36,24,24,12,18,44,40.9,26,23,4,19,24,84,13,0,Matches,72c812f3
958,Ignatius Ganago,cm CMR,FW,Lens,fr Ligue 1,22,1999,11.4,3,2,1,2,0,2,6,33.3,4,4,0,4,2,5,3,0,Matches,23c63b7f
959,Silvère Ganvoula M'Boussy,cg CGO,FW,Bochum,de Bundesliga,25,1996,1.7,0,0,0,0,0,0,1,0.0,1,0,0,0,0,0,1,0,Matches,6c731625
960,Álvaro García,es ESP,MF,Rayo Vallecano,es La Liga,28,1992,33.3,42,23,15,18,9,8,35,22.9,27,27,3,24,42,84,24,0,Matches,90bbd822
961,Dani García,es ESP,MF,Athletic Club,es La Liga,31,1990,24.2,36,22,15,17,4,14,47,29.8,33,27,10,17,24,60,41,1,Matches,240d3a0b
962,David García,es ESP,DF,Osasuna,es La Liga,27,1994,34.5,28,14,15,11,2,12,22,54.5,10,27,21,6,52,80,168,0,Matches,3e42f707
963,Eric García,es ESP,DF,Barcelona,es La Liga,20,2001,22.7,27,18,13,13,1,11,26,42.3,15,22,12,10,44,71,53,3,Matches,2bed3eab
964,Francisco Garcia,es ESP,DF,Rayo Vallecano,es La Liga,21,1999,33.6,60,35,44,12,4,39,73,53.4,34,34,8,26,45,105,53,0,Matches,7226539b
965,Joan García,es ESP,GK,Espanyol,es La Liga,20,2001,1.2,0,0,0,0,0,0,0,,0,0,0,0,1,1,1,2,Matches,87b498b0
966,Manu García,es ESP,MF,Alavés,es La Liga,23,1998,12.0,18,9,6,9,3,9,27,33.3,18,8,2,6,13,31,4,0,Matches,6ed1a2a2
967,Raúl García,es ESP,FW,Athletic Club,es La Liga,35,1986,20.0,27,17,6,11,10,8,36,22.2,28,30,4,26,9,36,21,0,Matches,b418dbd4
968,Rubén García,es ESP,MFFW,Osasuna,es La Liga,28,1993,26.4,43,26,12,23,8,16,49,32.7,33,31,4,27,24,67,16,0,Matches,5c96b017
969,Saúl García,es ESP,MF,Alavés,es La Liga,26,1994,0.0,1,1,1,0,0,0,0,,0,0,0,0,0,1,0,0,Matches,dafa5038
970,Unai García,es ESP,DF,Osasuna,es La Liga,29,1992,15.6,21,12,14,6,1,14,17,82.4,3,19,11,8,22,43,78,0,Matches,4a633cfe
971,Alejandro Garnacho,es ESP,MF,Manchester Utd,eng Premier League,17,2004,0.1,0,0,0,0,0,0,1,0.0,1,0,0,0,0,0,0,0,Matches,7aa8adfe
972,Mario Gaspar,es ESP,DF,Villarreal,es La Liga,30,1990,6.9,10,4,2,5,3,6,10,60.0,4,6,3,3,6,16,15,0,Matches,fb5d47b3
973,Djeidi Gassama,fr FRA,FW,Paris S-G,fr Ligue 1,17,2003,0.0,0,0,0,0,0,0,0,,0,1,1,0,0,0,0,0,Matches,bbdb2789
974,Johan Gastien,fr FRA,MF,Clermont Foot,fr Ligue 1,33,1988,30.5,56,34,26,25,5,27,74,36.5,47,45,11,34,53,109,49,1,Matches,868eaba0
975,Gavi,es ESP,MFFW,Barcelona,es La Liga,16,2004,25.7,38,18,13,18,7,9,33,27.3,24,36,0,36,25,63,13,0,Matches,19cae58d
976,Dwight Gayle,eng ENG,FWDF,Newcastle Utd,eng Premier League,30,1990,0.4,1,0,0,1,0,0,1,0.0,1,0,0,0,1,2,0,0,Matches,e58a03c6
977,Jean-Philippe Gbamin,ci CIV,MF,Everton,eng Premier League,25,1995,0.7,1,1,1,0,0,0,2,0.0,2,0,0,0,1,2,1,0,Matches,6bd603db
978,David de Gea,es ESP,GK,Manchester Utd,eng Premier League,30,1990,38.0,0,0,0,0,0,0,0,,0,0,0,0,0,0,11,2,Matches,7ba6d84e
979,Linus Gechter,de GER,DF,Hertha BSC,de Bundesliga,17,2004,8.0,15,8,13,2,0,7,14,50.0,7,12,7,5,11,26,29,0,Matches,ad2b068c
980,Dennis Geiger,de GER,MF,Hoffenheim,de Bundesliga,23,1998,15.3,34,23,9,20,5,17,30,56.7,13,15,1,14,14,48,7,1,Matches,37f606f0
981,Joe Gelhardt,eng ENG,FWMF,Leeds United,eng Premier League,19,2002,8.3,4,3,1,0,3,2,10,20.0,8,9,0,9,0,4,3,0,Matches,01962d0d
982,Luca Gemello,it ITA,GK,Torino,it Serie A,21,2000,1.0,0,0,0,0,0,0,0,,0,0,0,0,0,0,0,0,Matches,53e494ec
983,Yannick Gerhardt,de GER,MFDF,Wolfsburg,de Bundesliga,27,1994,17.5,42,20,18,17,7,22,36,61.1,14,24,1,23,25,67,25,1,Matches,62ab9184
984,Valère Germain,fr FRA,FWMF,Montpellier,fr Ligue 1,31,1990,21.9,23,14,6,11,6,8,31,25.8,23,13,1,12,9,32,27,0,Matches,ea0ff634
985,Gerson,br BRA,MFFW,Marseille,fr Ligue 1,24,1997,28.3,42,17,16,20,6,8,35,22.9,27,26,4,22,16,58,16,2,Matches,8827bf46
986,Willem Geubbels,fr FRA,MFFW,Nantes,fr Ligue 1,19,2001,6.0,8,5,4,2,2,5,12,41.7,7,5,0,5,6,14,5,0,Matches,9836e892
987,Hamadi Al Ghaddioui,ma MAR,FW,Stuttgart,de Bundesliga,30,1990,5.5,5,4,2,1,2,0,4,0.0,4,3,1,2,0,5,4,0,Matches,5723931e
988,Ismaël Gharbi,es ESP,MF,Paris S-G,fr Ligue 1,17,2004,0.0,0,0,0,0,0,0,0,,0,0,0,0,0,0,0,0,Matches,5b3cfa12
989,Anwar El Ghazi,nl NED,MFFW,Aston Villa,eng Premier League,26,1995,4.3,4,4,2,2,0,2,7,28.6,5,6,0,6,1,5,2,0,Matches,ffa90327
990,Anwar El Ghazi,nl NED,MF,Everton,eng Premier League,26,1995,0.1,1,1,1,0,0,1,1,100.0,0,3,0,3,0,1,0,0,Matches,ffa90327
991,Lamine Ghezali,fr FRA,DF,Saint-Étienne,fr Ligue 1,22,1999,0.0,0,0,0,0,0,0,0,,0,1,0,1,0,0,0,0,Matches,ce84946a
992,Paolo Ghiglione,it ITA,DF,Genoa,it Serie A,24,1997,6.7,17,12,8,6,3,9,14,64.3,5,11,5,6,10,27,12,1,Matches,71dc23da
993,Saman Ghoddos,ir IRN,MFDF,Brentford,eng Premier League,27,1993,6.0,17,10,8,6,3,9,15,60.0,6,2,0,2,3,20,16,0,Matches,f7b1d4e0
994,Faouzi Ghoulam,dz ALG,DF,Napoli,it Serie A,30,1991,3.7,3,1,1,2,0,0,3,0.0,3,2,1,1,3,6,10,0,Matches,c5adc293
995,Dimitris Giannoulis,gr GRE,DF,Norwich City,eng Premier League,25,1995,13.0,36,21,17,17,2,24,36,66.7,12,22,6,16,19,55,41,1,Matches,112c495e
996,Morgan Gibbs-White,eng ENG,DFFW,Wolves,eng Premier League,21,2000,0.1,0,0,0,0,0,0,0,,0,1,0,1,0,0,0,0,Matches,32f60ed8
997,Ben Gibson,eng ENG,DF,Norwich City,eng Premier League,28,1993,27.7,23,16,17,6,0,7,12,58.3,5,36,30,6,27,50,139,2,Matches,bcfb0142
998,Niko Gießelmann,de GER,DFFW,Union Berlin,de Bundesliga,29,1991,23.1,24,17,10,11,3,15,38,39.5,23,26,4,22,18,42,29,1,Matches,7242b495
999,Rafał Gikiewicz,pl POL,GK,Augsburg,de Bundesliga,33,1987,34.0,2,0,2,0,0,2,7,28.6,5,0,0,0,3,5,11,5,Matches,17376543
1000,Óscar Gil,es ESP,DF,Espanyol,es La Liga,23,1998,18.8,52,35,27,20,5,25,46,54.3,21,33,9,24,19,71,33,2,Matches,6652cf96
1001,Mario Gila,es ESP,DF,Real Madrid,es La Liga,20,2000,0.3,1,0,1,0,0,0,1,0.0,1,0,0,0,1,2,1,0,Matches,9c435456
1002,Billy Gilmour,sct SCO,MF,Norwich City,eng Premier League,20,2001,20.6,41,21,16,21,4,14,52,26.9,38,21,4,17,17,58,29,0,Matches,df10e27c
1003,Daniel Ginczek,de GER,MFFW,Wolfsburg,de Bundesliga,30,1991,0.1,0,0,0,0,0,0,0,,0,0,0,0,0,0,0,0,Matches,e5f63987
1004,Matthias Ginter,de GER,DF,M'Gladbach,de Bundesliga,27,1994,26.2,37,22,21,13,3,28,42,66.7,14,22,11,11,34,71,79,0,Matches,f521b80a
1005,Nicholas Gioacchini,us USA,MFFW,Montpellier,fr Ligue 1,21,2000,5.5,7,5,3,2,2,4,10,40.0,6,8,0,8,4,11,5,0,Matches,79ab7593
1006,Sebastian Giovinco,it ITA,MF,Sampdoria,it Serie A,34,1987,0.4,0,0,0,0,0,0,1,0.0,1,0,0,0,0,0,0,0,Matches,2b7c18ae
1007,Jimmy Giraudon,fr FRA,DF,Troyes,fr Ligue 1,29,1992,18.0,14,6,10,4,0,7,22,31.8,15,24,14,10,37,51,68,1,Matches,6ba71da5
1008,Andrei Girotto,br BRA,DFMF,Nantes,fr Ligue 1,29,1992,35.0,85,52,49,32,4,52,103,50.5,51,67,33,34,69,154,143,0,Matches,3befc2b6
1009,Olivier Giroud,fr FRA,FW,Milan,it Serie A,34,1986,21.0,15,11,4,6,5,3,17,17.6,14,13,4,9,3,18,19,0,Matches,16ceb862
1010,Serge Gnabry,de GER,MFFW,Bayern Munich,de Bundesliga,26,1995,24.3,47,31,16,20,11,22,57,38.6,35,26,0,26,14,61,3,0,Matches,88e357ef
1011,Ben Godfrey,eng ENG,DF,Everton,eng Premier League,23,1998,22.5,47,32,29,14,4,24,39,61.5,15,41,19,22,15,62,100,2,Matches,9f7c837d
1012,Diego Godín,uy URU,DF,Cagliari,it Serie A,35,1986,9.1,18,7,13,3,2,10,15,66.7,5,7,5,2,13,31,46,0,Matches,fc4f85b1
1013,Edoardo Goldaniga,it ITA,DF,Cagliari,it Serie A,27,1993,10.4,12,5,7,5,0,4,11,36.4,7,8,5,3,22,34,23,0,Matches,4b029b31
1014,Edoardo Goldaniga,it ITA,DFMF,Sassuolo,it Serie A,27,1993,0.0,0,0,0,0,0,0,0,,0,0,0,0,0,0,0,0,Matches,4b029b31
1015,Aleksandr Golovin,ru RUS,MF,Monaco,fr Ligue 1,25,1996,16.7,40,22,10,18,12,18,41,43.9,23,26,1,25,12,52,8,0,Matches,3708e9fa
1016,André Gomes,pt POR,MF,Everton,eng Premier League,28,1993,6.9,16,4,6,6,4,8,32,25.0,24,8,2,6,1,17,7,1,Matches,1961b2aa
1017,Angel Gomes,eng ENG,MFFW,Lille,fr Ligue 1,20,2000,10.6,23,13,6,12,5,10,15,66.7,5,4,0,4,3,26,4,0,Matches,645a3363
1018,Toti Gomes,pt POR,DF,Wolves,eng Premier League,22,1999,4.0,11,7,10,1,0,7,9,77.8,2,6,3,3,8,19,15,0,Matches,f0caab96
1019,Dani Gómez,es ESP,FW,Levante,es La Liga,23,1998,11.8,7,4,3,2,2,4,12,33.3,8,3,0,3,3,10,5,0,Matches,0e5ddc7c
1020,Joe Gomez,eng ENG,DF,Liverpool,eng Premier League,24,1997,3.7,10,6,5,2,3,5,9,55.6,4,4,1,3,5,15,6,0,Matches,7a11550b
1021,Maxi Gómez,uy URU,FW,Valencia,es La Liga,24,1996,21.7,5,3,1,2,2,5,8,62.5,3,5,1,4,3,8,22,0,Matches,4c2e9442
1022,Moi Gómez,es ESP,MFFW,Villarreal,es La Liga,27,1994,14.3,15,7,8,3,4,5,17,29.4,12,5,0,5,6,21,6,0,Matches,5a626448
1023,Papu Gómez,ar ARG,MFFW,Sevilla,es La Liga,33,1988,19.8,19,11,9,5,5,9,35,25.7,26,15,2,13,7,26,12,2,Matches,6e4df551
1024,Sergi Gómez,es ESP,DF,Espanyol,es La Liga,29,1992,30.2,33,24,29,3,1,18,27,66.7,9,33,23,10,40,73,125,2,Matches,bc6f5f06
1025,Alfred Gomis,sn SEN,GK,Rennes,fr Ligue 1,27,1993,25.0,1,0,1,0,0,1,2,50.0,1,0,0,0,1,2,8,2,Matches,cecbce23
1026,Maxime Gonalons,fr FRA,MF,Granada,es La Liga,32,1989,17.2,43,28,17,22,4,14,39,35.9,25,33,10,23,18,61,29,0,Matches,b8c1de25
1027,Vagner Gonçalves,cv CPV,FW,Metz,fr Ligue 1,25,1996,1.0,2,1,0,2,0,1,1,100.0,0,0,0,0,1,3,0,0,Matches,743fd71f
1028,Cedric Gondo,ci CIV,FW,Salernitana,it Serie A,24,1996,7.8,5,2,2,2,1,2,5,40.0,3,2,0,2,3,8,2,0,Matches,ff37d2ef
1029,Álvaro González,es ESP,DF,Marseille,fr Ligue 1,31,1990,5.0,1,1,1,0,0,1,1,100.0,0,0,0,0,1,2,9,0,Matches,42dcf26d
1030,Diego González,es ESP,DF,Elche,es La Liga,26,1995,19.9,25,16,18,7,0,9,16,56.3,7,21,13,8,19,44,87,0,Matches,4ac7608e
1031,Édgar González,es ESP,DF,Betis,es La Liga,24,1997,16.3,25,19,15,8,2,17,24,70.8,7,17,11,6,23,48,82,0,Matches,49d028db
1032,Giovanni González,uy URU,DF,Mallorca,es La Liga,26,1994,4.1,9,3,4,4,1,3,5,60.0,2,7,2,5,4,13,14,0,Matches,1fc474ae
1033,Nicolás González,ar ARG,FW,Fiorentina,it Serie A,23,1998,26.2,21,16,6,8,7,9,28,32.1,19,26,2,24,21,42,4,1,Matches,2374aaca
1034,Nicolás González,es ESP,MF,Barcelona,es La Liga,19,2002,12.4,31,20,5,23,3,11,27,40.7,16,12,0,12,6,37,12,0,Matches,2c56a792
1035,Peter González,do DOM,MFDF,Real Madrid,es La Liga,19,2002,0.3,0,0,0,0,0,0,0,,0,0,0,0,1,1,0,0,Matches,1ccd3dae
1036,Roberto González,es ESP,MF,Betis,es La Liga,20,2001,1.5,5,4,3,2,0,4,6,66.7,2,5,0,5,1,6,1,0,Matches,56545648
1037,Charlie Goode,eng ENG,DF,Brentford,eng Premier League,25,1995,5.0,7,5,5,2,0,4,4,100.0,0,4,2,2,2,9,8,0,Matches,7aee4dd3
1038,Anthony Gordon,eng ENG,MFFW,Everton,eng Premier League,20,2001,25.4,54,32,20,30,4,21,59,35.6,38,49,3,46,22,76,17,0,Matches,2bd83368
1039,Kaide Gordon,eng ENG,FW,Liverpool,eng Premier League,16,2004,0.1,1,0,0,0,1,0,0,,0,0,0,0,0,1,0,0,Matches,19a9cb70
1040,Leon Goretzka,de GER,MF,Bayern Munich,de Bundesliga,26,1995,15.5,25,15,12,9,4,11,26,42.3,15,11,1,10,17,42,23,2,Matches,cc86b9a3
1041,Gori,es ESP,MF,Espanyol,es La Liga,19,2002,0.1,0,0,0,0,0,0,0,,0,2,0,2,0,0,0,0,Matches,f3451c66
1042,Andoni Gorosabel,es ESP,DF,Real Sociedad,es La Liga,24,1996,25.4,47,31,32,9,6,25,47,53.2,22,16,3,13,18,65,49,0,Matches,6f5f82c0
1043,Robin Gosens,de GER,DF,Atalanta,it Serie A,27,1994,5.1,7,3,3,4,0,4,8,50.0,4,4,0,4,9,16,1,0,Matches,2d970560
1044,Robin Gosens,de GER,DF,Inter,it Serie A,27,1994,1.9,3,1,1,2,0,0,0,,0,5,2,3,3,6,3,0,Matches,2d970560
1045,Dan Gosling,eng ENG,MF,Watford,eng Premier League,31,1990,1.8,2,1,1,1,0,2,6,33.3,4,2,0,2,0,2,3,0,Matches,7fec31a0
1046,Amine Gouiri,fr FRA,FWMF,Nice,fr Ligue 1,21,2000,30.6,22,13,2,13,7,10,32,31.3,22,22,5,17,11,33,17,1,Matches,aad56ca3
1047,Lucas Gourna-Douath,fr FRA,MF,Saint-Étienne,fr Ligue 1,17,2003,20.0,45,26,22,18,5,21,36,58.3,15,22,3,19,13,58,9,2,Matches,3cd7820a
1048,Jeffrey Gouweleeuw,nl NED,DF,Augsburg,de Bundesliga,30,1991,28.6,50,27,33,17,0,22,36,61.1,14,35,18,17,49,99,116,0,Matches,1025db8e
1049,Jonathan Gradit,fr FRA,DF,Lens,fr Ligue 1,28,1992,34.1,60,28,24,28,8,25,45,55.6,20,39,27,12,65,125,106,0,Matches,06c48679
1050,Jens Grahl,de GER,GK,Eint Frankfurt,de Bundesliga,32,1988,1.0,0,0,0,0,0,0,0,,0,0,0,0,0,0,1,0,Matches,f26dee6b
1051,Alberto Grassi,it ITA,MF,Cagliari,it Serie A,26,1995,24.2,47,26,13,30,4,16,38,42.1,22,27,9,18,63,110,33,1,Matches,6cc97b6a
1052,Jaume Grau,es ESP,MF,Osasuna,es La Liga,24,1997,0.0,1,1,1,0,0,0,1,0.0,1,0,0,0,0,1,0,0,Matches,fc3d2006
1053,Andrew Gravillon,gp GLP,DF,Reims,fr Ligue 1,23,1998,23.7,32,24,19,13,0,17,27,63.0,10,25,15,10,33,65,83,1,Matches,49136c42
1054,Demarai Gray,eng ENG,MFFW,Everton,eng Premier League,25,1996,26.0,30,19,13,10,7,10,22,45.5,12,30,2,28,15,45,21,1,Matches,4468ec10
1055,Adrian Grbić,at AUT,FWMF,Lorient,fr Ligue 1,24,1996,5.8,2,1,0,2,0,2,6,33.3,4,3,1,2,0,2,7,0,Matches,4a987ffa
1056,Ivo Grbić,hr CRO,GK,Lille,fr Ligue 1,25,1996,21.0,0,0,0,0,0,0,0,,0,0,0,0,0,0,14,1,Matches,3f034750
1057,Jack Grealish,eng ENG,FWMF,Manchester City,eng Premier League,25,1995,21.3,18,17,4,10,4,5,13,38.5,8,11,1,10,8,26,7,0,Matches,b0b4fd3e
1058,Etienne Green,eng ENG,GK,Saint-Étienne,fr Ligue 1,21,2000,13.3,1,1,1,0,0,0,0,,0,0,0,0,1,2,9,0,Matches,667b65da
1059,Julian Green,us USA,MF,Greuther Fürth,de Bundesliga,26,1995,11.7,9,5,0,8,1,2,8,25.0,6,10,2,8,7,16,10,0,Matches,ad1d6fa4
1060,Mason Greenwood,eng ENG,MFFW,Manchester Utd,eng Premier League,19,2001,14.1,15,9,9,1,5,3,9,33.3,6,5,0,5,1,16,6,0,Matches,58eee997
1061,Sam Greenwood,eng ENG,MFFW,Leeds United,eng Premier League,19,2002,2.6,8,5,0,5,3,4,7,57.1,3,3,0,3,2,10,1,0,Matches,f3354c07
1062,Michael Gregoritsch,at AUT,FWMF,Augsburg,de Bundesliga,27,1994,15.5,19,8,4,10,5,2,15,13.3,13,18,2,16,6,25,30,0,Matches,8e235926
1063,Dominik Greif,sk SVK,GK,Mallorca,es La Liga,24,1997,1.0,0,0,0,0,0,0,0,,0,0,0,0,0,0,0,0,Matches,30061f53
1064,Clément Grenier,fr FRA,MF,Mallorca,es La Liga,30,1991,0.7,0,0,0,0,0,0,0,,0,1,1,0,0,0,1,0,Matches,8b298f56
1065,Sebastian Griesbeck,de GER,DFMF,Greuther Fürth,de Bundesliga,30,1990,27.1,60,31,38,19,3,39,62,62.9,23,38,13,25,43,103,100,1,Matches,a8db7ebb
1066,Sebastian Griesbeck,de GER,MF,Union Berlin,de Bundesliga,30,1990,0.1,1,1,0,1,0,1,1,100.0,0,0,0,0,0,1,0,0,Matches,a8db7ebb
1067,Antoine Griezmann,fr FRA,FW,Barcelona,es La Liga,30,1991,2.9,13,5,3,10,0,2,6,33.3,4,4,0,4,3,16,5,0,Matches,df69b544
1068,Antoine Griezmann,fr FRA,FWMF,Atlético Madrid,es La Liga,30,1991,18.8,30,14,11,15,4,12,32,37.5,20,18,1,17,7,37,18,0,Matches,df69b544
1069,Vincenzo Grifo,it ITA,MFFW,Freiburg,de Bundesliga,28,1993,30.8,27,15,9,13,5,9,26,34.6,17,12,2,10,13,40,28,0,Matches,54e4866f
1070,Lennart Grill,de GER,GK,Leverkusen,de Bundesliga,22,1999,1.0,0,0,0,0,0,0,0,,0,0,0,0,0,0,0,0,Matches,37998008
1071,Florian Grillitsch,at AUT,DFMF,Hoffenheim,de Bundesliga,25,1995,16.6,37,19,15,21,1,17,31,54.8,14,18,7,11,29,66,36,1,Matches,ffbbc83b
1072,Arnaut Groeneveld,nl NED,FW,Villarreal,es La Liga,24,1997,16.4,7,6,3,0,4,2,4,50.0,2,5,0,5,2,9,3,0,Matches,f08490a6
1073,Pascal Groß,de GER,MFDF,Brighton,eng Premier League,30,1991,22.6,28,15,15,11,2,12,33,36.4,21,34,8,26,18,46,23,0,Matches,8aec0537
1074,Carlos Gruezo,ec ECU,MF,Augsburg,de Bundesliga,26,1995,10.8,22,11,10,10,2,8,21,38.1,13,11,2,9,9,31,15,0,Matches,f2dd9a21
1075,Vicente Guaita,es ESP,GK,Crystal Palace,eng Premier League,34,1987,29.5,1,0,1,0,0,1,1,100.0,0,0,0,0,1,2,8,1,Matches,ab13a5aa
1076,Andrés Guardado,mx MEX,MF,Betis,es La Liga,34,1986,15.5,30,13,12,17,1,13,34,38.2,21,18,4,14,21,51,29,1,Matches,ef322658
1077,Sergi Guardiola,es ESP,FW,Rayo Vallecano,es La Liga,30,1991,19.0,10,9,3,5,2,1,21,4.8,20,14,2,12,4,14,17,0,Matches,32974271
1078,Nemanja Gudelj,rs SRB,DFMF,Sevilla,es La Liga,29,1991,11.6,16,7,10,4,2,5,8,62.5,3,14,9,5,22,38,37,0,Matches,0076ab7f
1079,Gabriel Gudmundsson,se SWE,DFMF,Lille,fr Ligue 1,22,1999,14.9,43,31,24,16,3,17,35,48.6,18,15,3,12,20,63,13,0,Matches,d5d22a58
1080,Noah Guede-Nadje,fr FRA,MF,Angers,fr Ligue 1,17,2003,0.0,0,0,0,0,0,0,0,,0,0,0,0,0,0,0,0,Matches,94b442c0
1081,Gonçalo Guedes,pt POR,FWMF,Valencia,es La Liga,24,1996,29.0,21,14,6,7,8,2,22,9.1,20,14,0,14,9,30,1,0,Matches,e6bc67d7
1082,Marc Guéhi,eng ENG,DF,Crystal Palace,eng Premier League,21,2000,35.8,35,17,24,10,1,15,16,93.8,1,34,26,8,30,65,127,0,Matches,d0706b27
1083,Mattéo Guendouzi,fr FRA,MF,Marseille,fr Ligue 1,22,1999,35.0,45,30,10,26,9,13,47,27.7,34,15,1,14,16,61,18,0,Matches,5ea8ef20
1084,Yanis Guermouche,fr FRA,MFFW,Montpellier,fr Ligue 1,20,2001,0.1,2,1,0,1,1,1,1,100.0,0,0,0,0,0,2,0,0,Matches,642f9f79
1085,Raphaël Guerreiro,pt POR,DF,Dortmund,de Bundesliga,27,1993,19.9,35,19,19,12,4,16,31,51.6,15,18,2,16,25,60,14,1,Matches,048a1cbc
1086,Evann Guessand,fr FRA,FW,Nice,fr Ligue 1,20,2001,4.9,9,8,2,5,2,3,8,37.5,5,4,0,4,0,9,1,0,Matches,b73f17f8
1087,Ander Guevara,es ESP,MF,Real Sociedad,es La Liga,24,1997,9.6,18,13,6,10,2,10,17,58.8,7,12,6,6,12,30,8,0,Matches,8e48dc61
1088,Lamine Gueye,sn SEN,FWMF,Metz,fr Ligue 1,23,1998,6.2,5,5,1,1,3,3,7,42.9,4,4,0,4,6,11,1,0,Matches,9d5dcc23
1089,Pape Gueye,sn SEN,MF,Marseille,fr Ligue 1,22,1999,17.0,38,19,15,22,1,16,31,51.6,15,15,3,12,24,62,16,0,Matches,7155e3e1
1090,John Guidetti,se SWE,FWMF,Alavés,es La Liga,29,1992,3.1,2,1,0,0,2,0,1,0.0,1,1,0,1,0,2,0,0,Matches,99bebd12
1091,Josuha Guilavogui,fr FRA,MFDF,Bordeaux,fr Ligue 1,30,1990,14.8,39,16,18,17,4,14,29,48.3,15,16,8,8,36,75,23,0,Matches,e6c43eec
1092,Josuha Guilavogui,fr FRA,MFDF,Wolfsburg,de Bundesliga,30,1990,10.5,23,14,13,9,1,7,18,38.9,11,11,6,5,25,48,42,0,Matches,e6c43eec
1093,Frederic Guilbert,fr FRA,DF,Strasbourg,fr Ligue 1,26,1994,28.0,69,39,33,24,12,32,62,51.6,30,37,11,26,55,124,39,0,Matches,5d8d7454
1094,Hugo Guillamón,es ESP,MFDF,Valencia,es La Liga,21,2000,26.2,43,27,20,16,7,18,44,40.9,26,26,10,16,30,73,53,1,Matches,f7c12fbf
1095,Bruno Guimarães,br BRA,MF,Newcastle Utd,eng Premier League,23,1997,11.5,44,23,18,22,4,21,38,55.3,17,25,6,19,9,53,13,0,Matches,82518f62
1096,Bruno Guimarães,br BRA,MF,Lyon,fr Ligue 1,23,1997,18.2,50,31,20,25,5,23,59,39.0,36,21,4,17,21,71,11,1,Matches,82518f62
1097,Sehrou Guirassy,gn GUI,FW,Rennes,fr Ligue 1,25,1996,11.3,4,2,1,2,1,1,7,14.3,6,4,0,4,1,5,8,0,Matches,923f4dda
1098,Péter Gulácsi,hu HUN,GK,RB Leipzig,de Bundesliga,31,1990,33.0,0,0,0,0,0,0,0,,0,0,0,0,1,1,15,1,Matches,bcb2ccd8
1099,Manuel Gulde,de GER,DF,Freiburg,de Bundesliga,30,1991,13.6,18,10,14,3,1,8,11,72.7,3,16,8,8,17,35,37,0,Matches,25ab9c9c
1100,Gerard Gumbau,es ESP,MF,Elche,es La Liga,26,1994,21.0,46,19,22,19,5,22,51,43.1,29,18,4,14,23,69,25,0,Matches,ac454a4f
1101,Robert Gumny,pl POL,DF,Augsburg,de Bundesliga,23,1998,25.2,48,29,25,20,3,25,43,58.1,18,24,7,17,28,76,57,3,Matches,1df0c0b9
1102,İlkay Gündoğan,de GER,MF,Manchester City,eng Premier League,30,1990,20.6,23,9,10,12,1,12,31,38.7,19,11,1,10,15,38,10,0,Matches,819b3158
1103,Angus Gunn,eng ENG,GK,Norwich City,eng Premier League,25,1996,9.0,0,0,0,0,0,0,0,,0,0,0,0,0,0,11,0,Matches,e082af5b
1104,Christian Günter,de GER,DFMF,Freiburg,de Bundesliga,28,1993,34.0,34,20,16,15,3,18,50,36.0,32,23,6,17,17,51,49,2,Matches,8593f88c
1105,Koray Günter,de GER,DF,Hellas Verona,it Serie A,26,1994,26.8,32,18,19,11,2,16,32,50.0,16,27,21,6,69,101,110,1,Matches,f1f1f238
1106,Lasse Günther,de GER,DF,Augsburg,de Bundesliga,18,2003,1.8,8,5,4,3,1,5,9,55.6,4,0,0,0,2,10,2,0,Matches,00672803
1107,Jon Guridi,es ESP,MF,Real Sociedad,es La Liga,26,1995,2.3,5,3,2,3,0,1,4,25.0,3,3,1,2,3,8,4,0,Matches,4c0a6a48
1108,Malo Gusto,fr FRA,DF,Lyon,fr Ligue 1,18,2003,20.9,55,35,29,21,5,24,40,60.0,16,21,6,15,33,88,41,1,Matches,d56b9520
1109,Raúl Guti,es ESP,MF,Elche,es La Liga,24,1996,18.1,25,15,7,14,4,10,30,33.3,20,9,3,6,25,50,7,0,Matches,0b2c8585
1110,Marcos Mauro López Gutiérrez,ar ARG,DF,Cádiz,es La Liga,30,1991,1.5,1,0,0,1,0,0,2,0.0,2,2,1,1,1,2,9,0,Matches,b3b62f94
1111,Miguel Gutiérrez,es ESP,DF,Real Madrid,es La Liga,20,2001,2.9,7,5,5,0,2,3,5,60.0,2,0,0,0,2,9,2,0,Matches,7e98cff1
1112,Albert Guðmundsson,is ISL,MF,Genoa,it Serie A,24,1997,6.7,5,3,2,1,2,3,8,37.5,5,2,0,2,5,10,4,0,Matches,b79858d5
1113,Joško Gvardiol,hr CRO,DF,RB Leipzig,de Bundesliga,19,2002,26.8,47,31,28,17,2,22,39,56.4,17,30,11,19,51,98,62,2,Matches,5ad50391
1114,Emmanuel Gyasi,gh GHA,MFFW,Spezia,it Serie A,27,1994,33.7,47,30,31,9,7,21,41,51.2,20,22,4,18,16,63,43,1,Matches,f9758dae
1115,Norbert Gyömbér,sk SVK,DF,Salernitana,it Serie A,29,1992,28.5,53,32,40,11,2,33,50,66.0,17,38,24,14,44,97,126,1,Matches,0be276c6
1116,Erling Haaland,no NOR,FW,Dortmund,de Bundesliga,21,2000,21.2,2,1,0,1,1,0,1,0.0,1,8,1,7,1,3,31,0,Matches,1f44ac21
1117,Nicolas Haas,ch SUI,MF,Empoli,it Serie A,25,1996,11.1,35,22,15,10,10,17,39,43.6,22,24,4,20,9,44,17,1,Matches,fa449bba
1118,Janik Haberer,de GER,MF,Freiburg,de Bundesliga,27,1994,9.1,14,8,5,6,3,7,19,36.8,12,11,4,7,16,30,11,0,Matches,70dcf94d
1119,Alexander Hack,de GER,DF,Mainz 05,de Bundesliga,27,1993,23.0,52,26,35,17,0,29,46,63.0,17,31,14,17,51,103,95,1,Matches,a5ec3ede
1120,Robin Hack,de GER,MFFW,Arminia,de Bundesliga,22,1998,15.2,14,8,6,5,3,3,21,14.3,18,18,1,17,5,19,4,0,Matches,0174ba21
1121,Munir El Haddadi,ma MAR,FWMF,Sevilla,es La Liga,25,1995,5.3,8,4,1,6,1,2,8,25.0,6,7,1,6,5,13,2,0,Matches,8696bc90
1122,André Hahn,de GER,MFFW,Augsburg,de Bundesliga,30,1990,23.3,35,20,9,14,12,16,49,32.7,33,38,5,33,15,50,43,0,Matches,cd82452e
1123,Amadou Haidara,ml MLI,MF,RB Leipzig,de Bundesliga,23,1998,14.7,30,14,11,19,0,17,37,45.9,20,22,6,16,16,46,8,1,Matches,92432bc6
1124,Massadio Haïdara,ml MLI,DF,Lens,fr Ligue 1,28,1992,12.0,28,21,18,7,3,15,24,62.5,9,18,4,14,22,50,31,0,Matches,5167c97e
1125,Oualid El Hajjam,ma MAR,DF,Troyes,fr Ligue 1,30,1991,11.9,22,11,12,6,4,15,23,65.2,8,12,6,6,22,44,28,0,Matches,9f29c204
1126,Achraf Hakimi,ma MAR,DF,Paris S-G,fr Ligue 1,22,1998,27.5,75,51,38,28,9,41,73,56.2,32,25,5,20,28,103,23,2,Matches,e42d61c7
1127,Marcel Halstenberg,de GER,DF,RB Leipzig,de Bundesliga,29,1991,5.6,10,7,6,4,0,6,11,54.5,5,6,0,6,7,17,11,0,Matches,8ff2354e
1128,Pierre-Yves Hamel,fr FRA,FWMF,Lorient,fr Ligue 1,27,1994,0.3,0,0,0,0,0,0,1,0.0,1,0,0,0,2,2,0,0,Matches,a99da9ec
1129,Pierre-Yves Hamel,fr FRA,FW,Clermont Foot,fr Ligue 1,27,1994,5.8,11,6,0,5,6,5,6,83.3,1,2,1,1,0,11,0,0,Matches,a99da9ec
1130,Romain Hamouma,fr FRA,FWMF,Saint-Étienne,fr Ligue 1,34,1987,9.8,10,7,1,5,4,2,13,15.4,11,8,0,8,4,14,1,0,Matches,0b4d8274
1131,Samir Handanović,si SVN,GK,Inter,it Serie A,37,1984,37.0,1,0,1,0,0,1,2,50.0,1,1,0,1,0,1,6,3,Matches,74419746
1132,Grant Hanley,sct SCO,DF,Norwich City,eng Premier League,29,1991,32.2,44,25,28,14,2,18,35,51.4,17,56,45,11,56,100,176,2,Matches,e9254eec
1133,Ridgeciano Haps,sr SUR,DF,Venezia,it Serie A,28,1993,22.8,36,20,26,4,6,11,21,52.4,10,34,12,22,29,65,57,1,Matches,c8d7131c
1134,Genki Haraguchi,jp JPN,MF,Union Berlin,de Bundesliga,30,1991,19.5,37,20,12,22,3,15,48,31.3,33,25,3,22,26,63,15,0,Matches,f24ea523
1135,Amine Harit,ma MAR,FWMF,Marseille,fr Ligue 1,24,1997,12.9,18,11,9,9,0,9,17,52.9,8,10,0,10,4,22,2,0,Matches,e7d59f4f
1136,Varazdat Haroyan,am ARM,DF,Cádiz,es La Liga,28,1992,16.0,31,21,20,10,1,19,29,65.5,10,22,12,10,15,46,62,0,Matches,be32269e
1137,Jack Harrison,eng ENG,MFFW,Leeds United,eng Premier League,24,1996,29.3,57,37,22,22,13,31,76,40.8,45,35,1,34,21,78,19,0,Matches,aa849a12
1138,Abdou Harroui,nl NED,MF,Sassuolo,it Serie A,23,1998,5.0,11,4,4,7,0,8,11,72.7,3,14,0,14,4,15,5,0,Matches,65fd099c
1139,Luis Hartwig,de GER,FW,Bochum,de Bundesliga,18,2002,0.0,0,0,0,0,0,0,0,,0,0,0,0,0,0,0,0,Matches,a3f30508
1140,Makoto Hasebe,jp JPN,DF,Eint Frankfurt,de Bundesliga,37,1984,13.2,27,12,15,11,1,13,29,44.8,16,24,8,16,22,49,36,0,Matches,9ab16552
1141,Hans Hateboer,nl NED,DFMF,Atalanta,it Serie A,27,1994,15.4,22,14,10,8,4,11,26,42.3,15,11,1,10,7,29,20,0,Matches,3b333ac3
1142,Kortney Hause,eng ENG,DF,Aston Villa,eng Premier League,26,1995,4.4,3,3,2,0,1,3,4,75.0,1,8,5,3,6,9,13,0,Matches,bf8fad51
1143,Kai Havertz,de GER,FWMF,Chelsea,eng Premier League,22,1999,20.1,17,8,5,7,5,4,14,28.6,10,28,1,27,4,21,32,1,Matches,fed7cb61
1144,Isaac Hayden,eng ENG,MFDF,Newcastle Utd,eng Premier League,26,1995,11.1,28,14,11,14,3,12,29,41.4,17,17,8,9,14,42,24,0,Matches,c951a6df
1145,Eden Hazard,be BEL,FWMF,Real Madrid,es La Liga,30,1991,8.0,6,3,3,2,1,3,7,42.9,4,3,0,3,2,8,0,0,Matches,a39bb753
1146,Thorgan Hazard,be BEL,MFDF,Dortmund,de Bundesliga,28,1993,14.9,23,13,8,10,5,15,40,37.5,25,23,1,22,6,29,4,0,Matches,50871bcc
1147,Jonas Hector,de GER,DF,Köln,de Bundesliga,31,1990,28.4,76,39,36,26,14,29,74,39.2,45,59,8,51,50,126,68,1,Matches,c2009df3
1148,Hwang Hee-chan,kr KOR,FWMF,Wolves,eng Premier League,25,1996,20.2,27,13,9,16,2,14,44,31.8,30,10,0,10,13,40,7,1,Matches,169fd162
1149,Hwang Hee-chan,kr KOR,FWMF,RB Leipzig,de Bundesliga,25,1996,0.5,0,0,0,0,0,0,0,,0,0,0,0,1,1,0,0,Matches,169fd162
1150,Silvan Hefti,ch SUI,DF,Genoa,it Serie A,23,1997,14.3,50,30,23,22,5,32,58,55.2,26,20,4,16,20,70,34,1,Matches,f8342731
1151,Dominique Heintz,de GER,DF,Union Berlin,de Bundesliga,27,1993,5.2,8,5,5,3,0,3,6,50.0,3,7,4,3,7,15,14,0,Matches,699fb8db
1152,Dominique Heintz,de GER,DF,Freiburg,de Bundesliga,27,1993,0.3,0,0,0,0,0,0,0,,0,0,0,0,1,1,0,0,Matches,699fb8db
1153,Jordan Henderson,eng ENG,MF,Liverpool,eng Premier League,31,1990,28.9,36,20,9,25,2,17,44,38.6,27,25,1,24,23,59,14,0,Matches,935e6b8f
1154,Liam Henderson,sct SCO,MF,Empoli,it Serie A,25,1996,22.4,22,13,7,8,7,9,31,29.0,22,14,4,10,9,31,13,0,Matches,d7918b13
1155,Jeff Hendrick,ie IRL,MF,Newcastle Utd,eng Premier League,29,1992,0.8,1,1,0,1,0,1,1,100.0,0,0,0,0,0,1,1,0,Matches,989d5705
1156,Wayne Hennessey,wls WAL,GK,Burnley,eng Premier League,34,1987,2.0,0,0,0,0,0,0,0,,0,0,0,0,1,1,0,1,Matches,76eca7e2
1157,Benjamin Henrichs,de GER,DF,RB Leipzig,de Bundesliga,24,1997,12.7,30,21,18,6,6,12,22,54.5,10,16,1,15,19,49,14,0,Matches,0a89e877
1158,Henrique,br BRA,DF,Lyon,fr Ligue 1,27,1994,12.3,13,7,10,1,2,5,16,31.3,11,13,1,12,22,35,14,0,Matches,f28474a4
1159,Dalbert Henrique,br BRA,DFMF,Cagliari,it Serie A,27,1993,23.1,43,23,23,16,4,11,35,31.4,24,28,5,23,24,67,34,0,Matches,f45f9427
1160,Luis Henrique,br BRA,FWMF,Marseille,fr Ligue 1,19,2001,7.8,4,3,2,1,1,2,5,40.0,3,2,0,2,5,9,1,0,Matches,f36d5624
1161,Matheus Henrique,br BRA,MF,Sassuolo,it Serie A,23,1997,12.0,10,3,6,3,1,6,24,25.0,18,14,2,12,7,17,12,1,Matches,a2d9f138
1162,Rico Henry,eng ENG,DF,Brentford,eng Premier League,24,1997,30.8,28,20,18,8,2,12,34,35.3,22,31,10,21,26,54,76,1,Matches,8a3c1dc7
1163,Thomas Henry,fr FRA,FW,Venezia,it Serie A,26,1994,23.5,9,4,2,3,4,5,13,38.5,8,11,5,6,2,11,25,0,Matches,9ef42479
1164,Christophe Hérelle,mq MTQ,DF,Brest,fr Ligue 1,28,1992,21.5,48,28,30,16,2,17,26,65.4,9,20,15,5,44,92,84,1,Matches,3681cfff
1165,Jérôme Hergault,fr FRA,DF,Lorient,fr Ligue 1,35,1986,3.9,3,1,1,2,0,2,5,40.0,3,4,1,3,4,7,7,0,Matches,a84f9a4b
1166,Kike Hermoso,es ESP,DF,Betis,es La Liga,21,1999,1.0,2,1,2,0,0,2,2,100.0,0,2,1,1,0,2,5,1,Matches,dea912dc
1167,Mario Hermoso,es ESP,DF,Atlético Madrid,es La Liga,26,1995,20.7,30,15,23,4,3,20,38,52.6,18,18,3,15,29,59,49,2,Matches,555f3a0b
1168,Aridane Hernández,gq EQG,DF,Osasuna,es La Liga,32,1989,12.9,12,9,10,2,0,3,13,23.1,10,11,9,2,20,32,71,0,Matches,132ac341
1169,Lucas Hernández,fr FRA,DF,Bayern Munich,de Bundesliga,25,1996,22.6,50,31,20,24,6,26,42,61.9,16,22,11,11,28,78,54,1,Matches,c3ee18ef
1170,Luis Hernández,es ESP,DF,Cádiz,es La Liga,32,1989,15.2,9,5,9,0,0,5,8,62.5,3,5,3,2,16,25,34,0,Matches,02d2c436
1171,Mario Hernández,es ESP,DFMF,Rayo Vallecano,es La Liga,22,1999,4.4,10,4,7,3,0,5,9,55.6,4,1,0,1,4,14,7,0,Matches,90162357
1172,Theo Hernández,fr FRA,DF,Milan,it Serie A,23,1997,30.1,53,35,34,14,5,29,40,72.5,11,16,3,13,23,76,29,3,Matches,d4c9725f
1173,Hernani,br BRA,MFFW,Genoa,it Serie A,27,1994,7.6,20,10,8,9,3,13,32,40.6,19,17,4,13,13,33,5,1,Matches,6f5ead86
1174,Ander Herrera,es ESP,MF,Paris S-G,fr Ligue 1,31,1989,12.1,29,17,7,16,6,14,39,35.9,25,22,8,14,14,43,8,0,Matches,436a9dd0
1175,Héctor Herrera,mx MEX,MF,Atlético Madrid,es La Liga,31,1990,9.5,16,8,11,4,1,7,20,35.0,13,13,2,11,12,28,16,0,Matches,a8542814
1176,Sergio Herrera,es ESP,GK,Osasuna,es La Liga,28,1993,36.0,3,2,3,0,0,3,6,50.0,3,1,0,1,1,4,18,0,Matches,a4995f48
1177,Yangel Herrera,ve VEN,MF,Espanyol,es La Liga,23,1998,18.3,41,31,19,19,3,18,39,46.2,21,27,5,22,19,60,33,1,Matches,e778654a
1178,Patrick Herrmann,de GER,MFDF,M'Gladbach,de Bundesliga,30,1991,8.4,15,7,5,6,4,9,24,37.5,15,10,1,9,6,21,8,0,Matches,dfb6490a
1179,Son Heung-min,kr KOR,MFFW,Tottenham,eng Premier League,29,1992,33.4,15,6,5,7,3,5,23,21.7,18,27,6,21,13,28,8,0,Matches,92e7e919
1180,Daan Heymans,be BEL,MFFW,Venezia,it Serie A,22,1999,2.8,3,1,1,2,0,1,5,20.0,4,7,3,4,4,7,3,0,Matches,6d70c771
1181,Aaron Hickey,sct SCO,DF,Bologna,it Serie A,19,2002,31.3,46,29,24,15,7,20,30,66.7,10,36,13,23,29,75,44,0,Matches,1780bb4a
1182,Piero Hincapié,ec ECU,DF,Leverkusen,de Bundesliga,19,2002,19.5,33,23,23,8,2,19,25,76.0,6,34,15,19,33,66,56,2,Matches,0c7a48f8
1183,Martin Hinteregger,at AUT,DF,Eint Frankfurt,de Bundesliga,28,1992,24.7,45,28,28,16,1,28,43,65.1,15,36,16,20,42,87,78,3,Matches,080440a4
1184,Marwin Hitz,ch SUI,GK,Dortmund,de Bundesliga,33,1987,4.5,0,0,0,0,0,0,0,,0,0,0,0,0,0,2,0,Matches,2e7ff968
1185,Ki-Jana Hoever,nl NED,DFMF,Wolves,eng Premier League,19,2002,3.4,10,6,5,5,0,7,12,58.3,5,6,0,6,6,16,8,0,Matches,9a71e978
1186,Nicolas Höfler,de GER,MF,Freiburg,de Bundesliga,31,1990,28.9,73,42,37,29,7,28,62,45.2,34,50,21,29,46,119,42,0,Matches,5d8e331f
1187,Jonas Hofmann,de GER,MF,M'Gladbach,de Bundesliga,29,1992,23.1,30,20,6,17,7,17,42,40.5,25,23,0,23,12,42,10,0,Matches,2903a856
1188,Rob Holding,eng ENG,DF,Arsenal,eng Premier League,25,1995,9.4,13,9,11,1,1,5,6,83.3,1,23,18,5,10,23,42,1,Matches,d79a8c87
1189,Lucas Höler,de GER,FW,Freiburg,de Bundesliga,27,1994,28.7,41,25,10,17,14,13,28,46.4,15,25,4,21,17,58,39,2,Matches,ca618d23
1190,Mason Holgate,eng ENG,DF,Everton,eng Premier League,24,1996,23.7,35,18,26,9,0,11,26,42.3,15,25,17,8,26,61,95,1,Matches,d0042ab9
1191,Gerrit Holtmann,ph PHI,FWMF,Bochum,de Bundesliga,26,1995,20.4,15,9,5,3,7,6,23,26.1,17,28,2,26,8,23,7,0,Matches,2979c05a
1192,Martin Hongla,cm CMR,MF,Hellas Verona,it Serie A,23,1998,7.2,14,8,5,6,3,4,8,50.0,4,6,2,4,4,18,16,1,Matches,b85bf253
1193,Franck Honorat,fr FRA,MFFW,Brest,fr Ligue 1,24,1996,32.2,54,38,25,13,16,27,48,56.3,21,24,2,22,15,69,25,0,Matches,db7849ca
1194,Justin Hoogma,nl NED,DF,Greuther Fürth,de Bundesliga,23,1998,3.0,6,5,4,2,0,4,6,66.7,2,5,5,0,4,10,4,0,Matches,816192f0
1195,Sydney van Hooijdonk,nl NED,FWMF,Bologna,it Serie A,21,2000,0.4,0,0,0,0,0,0,1,0.0,1,1,0,1,0,0,0,0,Matches,5b418e15
1196,Matthew Hoppe,us USA,FWMF,Mallorca,es La Liga,20,2001,1.5,1,0,0,0,1,0,3,0.0,3,0,0,0,0,1,0,0,Matches,1bc432b7
1197,Jannes Horn,de GER,DF,Köln,de Bundesliga,24,1997,5.3,6,4,4,2,0,4,8,50.0,4,1,1,0,3,9,9,0,Matches,2b83fa49
1198,Timo Horn,de GER,GK,Köln,de Bundesliga,28,1993,13.0,0,0,0,0,0,0,1,0.0,1,0,0,0,0,0,5,0,Matches,3cd9e95a
1199,Fraser Hornby,sct SCO,FWMF,Reims,fr Ligue 1,21,1999,3.9,3,1,1,2,0,0,2,0.0,2,3,0,3,4,7,5,0,Matches,29aee77c
1200,Cédric Hountondji,bj BEN,DF,Clermont Foot,fr Ligue 1,27,1994,22.6,33,17,20,12,1,16,24,66.7,8,23,12,11,34,67,76,0,Matches,00891164
1201,Lukáš Hrádecký,fi FIN,GK,Leverkusen,de Bundesliga,31,1989,32.0,1,1,1,0,0,1,1,100.0,0,0,0,0,0,1,10,1,Matches,ad3389d5
1202,Branimir Hrgota,se SWE,FWMF,Greuther Fürth,de Bundesliga,28,1993,30.9,46,29,10,31,5,21,72,29.2,51,27,1,26,11,57,3,1,Matches,710fbdd1
1203,Petko Hristov,bg BUL,DF,Spezia,it Serie A,22,1999,13.9,17,10,11,6,0,10,16,62.5,6,29,23,6,19,36,47,0,Matches,d8800a46
1204,Ajdin Hrustic,au AUS,MF,Eint Frankfurt,de Bundesliga,25,1996,10.7,16,11,5,7,4,11,32,34.4,21,18,1,17,10,26,7,0,Matches,1f2d714c
1205,Timo Hübers,de GER,DF,Köln,de Bundesliga,25,1996,19.3,45,27,28,17,0,27,45,60.0,18,31,19,12,52,97,95,0,Matches,94302c52
1206,Benjamin Hübner,de GER,DF,Hoffenheim,de Bundesliga,32,1989,4.2,9,5,0,7,2,3,5,60.0,2,2,2,0,9,18,7,0,Matches,99de6b6f
1207,Callum Hudson-Odoi,eng ENG,MFFW,Chelsea,eng Premier League,20,2000,10.7,14,10,5,6,3,8,23,34.8,15,8,0,8,2,16,6,1,Matches,15f3ec41
1208,Will Hughes,eng ENG,MF,Crystal Palace,eng Premier League,26,1995,11.7,29,14,10,16,3,7,16,43.8,9,13,7,6,8,37,10,0,Matches,a0666d3e
1209,Mats Hummels,de GER,DF,Dortmund,de Bundesliga,32,1988,19.6,34,22,20,13,1,20,36,55.6,16,18,13,5,32,66,66,1,Matches,05d548d8
1210,Elseid Hysaj,al ALB,DF,Lazio,it Serie A,27,1994,22.5,46,30,25,17,4,29,45,64.4,16,18,6,12,24,70,34,1,Matches,2f3452eb
1211,Suk Hyun-jun,kr KOR,FWMF,Troyes,fr Ligue 1,30,1991,1.7,0,0,0,0,0,0,0,,0,2,0,2,0,0,2,0,Matches,7ffaf233
1212,Pierre Højbjerg,dk DEN,MF,Tottenham,eng Premier League,25,1995,35.5,78,45,31,38,9,38,85,44.7,47,61,13,48,48,126,54,0,Matches,8b04d6c1
1213,Iago,br BRA,DF,Augsburg,de Bundesliga,24,1997,24.2,49,29,25,19,5,15,34,44.1,19,28,6,22,27,76,62,0,Matches,054849d2
1214,Robert Ibáñez,es ESP,MFFW,Osasuna,es La Liga,28,1993,1.0,3,3,2,0,1,1,2,50.0,1,1,0,1,1,4,1,0,Matches,c7429db3
1215,Roger Ibanez,br BRA,DF,Roma,it Serie A,22,1998,32.1,54,32,31,19,4,26,43,60.5,17,26,7,19,62,116,104,2,Matches,82efe6fa
1216,Vicente Iborra,es ESP,MF,Villarreal,es La Liga,33,1988,11.5,19,10,9,7,3,12,24,50.0,12,11,5,6,11,30,27,1,Matches,ad1ffcfd
1217,Zlatan Ibrahimović,se SWE,FW,Milan,it Serie A,39,1981,11.3,0,0,0,0,0,0,2,0.0,2,2,1,1,3,3,9,0,Matches,4cde5509
1218,Mauro Icardi,ar ARG,FW,Paris S-G,fr Ligue 1,28,1993,11.4,5,3,1,3,1,3,7,42.9,4,3,0,3,5,10,12,0,Matches,43b78598
1219,Adam Idah,ie IRL,FWMF,Norwich City,eng Premier League,20,2001,6.9,9,6,2,5,2,2,3,66.7,1,4,2,2,3,12,7,0,Matches,291e3ec3
1220,Oussama Idrissi,ma MAR,MFFW,Sevilla,es La Liga,25,1996,1.4,1,0,0,1,0,0,1,0.0,1,1,0,1,1,2,1,0,Matches,34caa4b3
1221,Oussama Idrissi,ma MAR,MF,Cádiz,es La Liga,25,1996,10.0,8,4,3,4,1,4,15,26.7,11,8,0,8,3,11,5,0,Matches,34caa4b3
1222,Iglesias,es ESP,DF,Getafe,es La Liga,23,1998,8.0,19,10,11,8,0,7,17,41.2,10,8,2,6,10,29,28,0,Matches,974322dc
1223,Borja Iglesias,es ESP,FW,Betis,es La Liga,28,1993,17.5,6,4,1,2,3,0,8,0.0,8,11,1,10,4,10,7,0,Matches,75645f0e
1224,Jonathan Iglesias,uy URU,MF,Clermont Foot,fr Ligue 1,32,1988,6.4,18,11,6,10,2,10,18,55.6,8,8,2,6,5,23,2,1,Matches,639ca1cf
1225,Juan Ignacio Ramírez,uy URU,FWMF,Saint-Étienne,fr Ligue 1,24,1997,1.4,2,1,0,1,1,0,0,,0,0,0,0,0,2,0,0,Matches,ad513a6b
1226,Igor,br BRA,DF,Fiorentina,it Serie A,23,1998,24.9,53,31,34,16,3,30,40,75.0,10,37,19,18,31,84,46,4,Matches,a4e85758
1227,Kelechi Iheanacho,ng NGA,FW,Leicester City,eng Premier League,24,1996,14.0,10,7,2,5,3,3,14,21.4,11,19,0,19,4,14,10,0,Matches,c92e1a31
1228,Danylo Ihnatenko,ua UKR,MF,Bordeaux,fr Ligue 1,24,1997,7.7,17,9,7,8,2,10,24,41.7,14,9,2,7,6,23,17,1,Matches,65bbfba3
1229,Jonathan Ikone,fr FRA,FW,Fiorentina,it Serie A,23,1998,7.2,7,3,2,3,2,3,10,30.0,7,10,2,8,1,8,2,0,Matches,42eaa028
1230,Jonathan Ikone,fr FRA,MFFW,Lille,fr Ligue 1,23,1998,11.8,11,3,6,4,1,4,11,36.4,7,13,1,12,5,16,4,0,Matches,42eaa028
1231,Ivan Ilić,rs SRB,MF,Hellas Verona,it Serie A,20,2001,28.1,39,18,16,19,4,20,54,37.0,34,34,12,22,22,61,55,0,Matches,bb376bed
1232,Josip Iličić,si SVN,MFFW,Atalanta,it Serie A,33,1988,9.3,7,7,3,2,2,4,17,23.5,13,6,1,5,3,10,1,0,Matches,68252d6d
1233,Asier Illarramendi,es ESP,MF,Real Sociedad,es La Liga,31,1990,4.2,9,5,5,3,1,1,10,10.0,9,5,1,4,4,13,12,0,Matches,5ce0b5ba
1234,Stefan Ilsanker,at AUT,DFMF,Eint Frankfurt,de Bundesliga,32,1989,3.0,14,8,7,6,1,5,10,50.0,5,6,2,4,6,20,15,1,Matches,8494acc4
1235,Ciro Immobile,it ITA,FW,Lazio,it Serie A,31,1990,30.1,10,5,4,4,2,1,15,6.7,14,7,1,6,3,13,16,0,Matches,4431aed2
1236,Burak İnce,tr TUR,FW,Arminia,de Bundesliga,17,2004,1.5,1,1,1,0,0,1,2,50.0,1,1,0,1,0,1,0,0,Matches,683dec01
1237,Danny Ings,eng ENG,FW,Aston Villa,eng Premier League,29,1992,21.1,23,16,2,16,5,13,37,35.1,24,31,2,29,6,29,22,0,Matches,07802f7f
1238,Marcus Ingvartsen,dk DEN,MF,Union Berlin,de Bundesliga,25,1996,1.4,0,0,0,0,0,0,2,0.0,2,0,0,0,2,2,1,0,Matches,271b8617
1239,Marcus Ingvartsen,dk DEN,FWMF,Mainz 05,de Bundesliga,25,1996,7.6,3,2,2,0,1,3,9,33.3,6,6,0,6,6,9,7,1,Matches,271b8617
1240,Bonke Innocent,ng NGA,MF,Lorient,fr Ligue 1,25,1996,9.7,27,16,10,16,1,11,26,42.3,15,11,3,8,16,43,14,0,Matches,546bb36e
1241,Lorenzo Insigne,it ITA,MFFW,Napoli,it Serie A,30,1991,25.4,23,14,8,12,3,8,44,18.2,36,30,1,29,20,43,3,1,Matches,2f557579
1242,Nikita Iosifov,ru RUS,MF,Villarreal,es La Liga,20,2001,0.0,0,0,0,0,0,0,0,,0,0,0,0,0,0,0,0,Matches,4c2fa917
1243,Tim Iroegbunam,eng ENG,MF,Aston Villa,eng Premier League,18,2003,1.0,5,4,2,3,0,1,1,100.0,0,0,0,0,2,7,1,0,Matches,84c5ceea
1244,Alexander Isak,se SWE,FW,Real Sociedad,es La Liga,21,1999,23.8,7,4,1,3,3,2,12,16.7,10,14,2,12,3,10,10,0,Matches,8e92be30
1245,Isco,es ESP,MFFW,Real Madrid,es La Liga,29,1992,3.7,9,5,4,4,1,5,12,41.7,7,1,0,1,2,11,1,0,Matches,a0b4bb3e
1246,Wilson Isidor,fr FRA,MFFW,Monaco,fr Ligue 1,20,2000,0.6,0,0,0,0,0,0,4,0.0,4,1,0,1,0,0,0,0,Matches,a671316d
1247,Ardian Ismajli,al ALB,DF,Empoli,it Serie A,24,1996,14.1,13,9,8,4,1,5,14,35.7,9,21,11,10,24,37,80,0,Matches,6b635f5c
1248,Hiroki Ito,jp JPN,DF,Stuttgart,de Bundesliga,22,1999,26.1,43,31,21,19,3,25,43,58.1,18,40,19,21,53,96,95,0,Matches,204dded0
1249,Cedric Itten,ch SUI,FW,Greuther Fürth,de Bundesliga,24,1996,7.1,5,2,1,2,2,1,6,16.7,5,3,0,3,2,7,4,0,Matches,ef233486
1250,Gian-Luca Itter,de GER,DF,Greuther Fürth,de Bundesliga,22,1999,16.2,44,26,30,11,3,21,38,55.3,17,24,9,15,13,57,51,0,Matches,e6c15f6e
1251,Alex Iwobi,ng NGA,MFDF,Everton,eng Premier League,25,1996,22.6,40,19,23,12,5,21,52,40.4,31,39,3,36,20,60,25,2,Matches,6ca5ec4b
1252,Armando Izzo,it ITA,DF,Torino,it Serie A,29,1992,5.8,16,9,14,2,0,9,11,81.8,2,5,4,1,17,33,21,0,Matches,89976232
1253,Nicolas Jackson,sn SEN,FWMF,Villarreal,es La Liga,20,2001,1.8,2,0,1,0,1,0,0,,0,0,0,0,1,3,1,0,Matches,9c36ed83
1254,Lee Jae-sung,kr KOR,MFFW,Mainz 05,de Bundesliga,28,1992,16.0,30,12,8,14,8,6,27,22.2,21,20,2,18,18,48,18,0,Matches,34b0387f
1255,Paul Jaeckel,de GER,DF,Union Berlin,de Bundesliga,23,1998,22.7,51,29,27,24,0,29,51,56.9,22,34,10,24,57,108,81,0,Matches,a93b6f4e
1256,Mato Jajalo,ba BIH,MF,Udinese,it Serie A,33,1988,7.0,24,14,14,7,3,11,23,47.8,12,7,0,7,11,35,5,0,Matches,8c65eb5f
1257,Kristijan Jakić,hr CRO,MF,Eint Frankfurt,de Bundesliga,24,1997,20.9,37,22,10,21,6,15,62,24.2,47,33,3,30,21,58,25,1,Matches,a8ee54ad
1258,Ismail Jakobs,sn SEN,DFMF,Monaco,fr Ligue 1,21,1999,13.4,32,16,14,15,3,16,35,45.7,19,16,1,15,17,49,31,0,Matches,a0415710
1259,Marin Jakoliš,hr CRO,FWMF,Angers,fr Ligue 1,24,1996,2.5,2,1,0,1,1,0,6,0.0,6,0,0,0,1,3,0,0,Matches,96f4ebc0
1260,Abdel Jalil Medioub,dz ALG,DF,Bordeaux,fr Ligue 1,23,1997,6.9,9,5,5,3,1,3,4,75.0,1,8,4,4,12,21,34,0,Matches,4937a9f7
1261,Daniel James,wls WAL,MF,Manchester Utd,eng Premier League,23,1997,1.4,2,1,0,2,0,0,0,,0,2,0,2,0,2,1,0,Matches,c931d9f9
1262,Daniel James,wls WAL,FWMF,Leeds United,eng Premier League,23,1997,26.3,24,14,8,8,8,10,23,43.5,13,18,1,17,8,32,12,0,Matches,c931d9f9
1263,Reece James,eng ENG,DF,Chelsea,eng Premier League,21,1999,20.7,33,25,14,18,1,9,22,40.9,13,20,2,18,17,50,22,0,Matches,1265a93a
1264,Vitaly Janelt,de GER,MF,Brentford,eng Premier League,23,1998,25.5,61,32,26,27,8,27,53,50.9,26,23,7,16,28,89,35,0,Matches,8449d35e
1265,Jakub Jankto,cz CZE,DFMF,Getafe,es La Liga,25,1996,6.5,11,7,5,5,1,10,17,58.8,7,4,0,4,4,15,7,0,Matches,1ea5f91c
1266,Pontus Jansson,se SWE,DF,Brentford,eng Premier League,30,1991,36.9,40,21,32,8,0,22,34,64.7,12,37,27,10,52,92,187,0,Matches,172e52d8
1267,Tony Jantschke,de GER,DF,M'Gladbach,de Bundesliga,31,1990,2.5,6,5,2,4,0,3,6,50.0,3,3,2,1,5,11,8,0,Matches,34b54da7
1268,Adnan Januzaj,be BEL,MFFW,Real Sociedad,es La Liga,26,1995,18.1,17,11,5,8,4,9,24,37.5,15,15,3,12,12,29,15,0,Matches,4737cebe
1269,Paweł Jaroszyński,pl POL,DF,Salernitana,it Serie A,26,1994,5.7,10,5,7,3,0,5,7,71.4,2,4,0,4,10,20,19,0,Matches,958a601f
1270,Jason,es ESP,MF,Alavés,es La Liga,27,1994,7.5,11,7,6,4,1,7,20,35.0,13,7,0,7,7,18,5,0,Matches,9038c2a1
1271,Jason,es ESP,MFDF,Valencia,es La Liga,27,1994,0.8,4,1,2,1,1,0,1,0.0,1,2,0,2,1,5,1,0,Matches,9038c2a1
1272,Dennis Jastrzembski,pl POL,DFMF,Hertha BSC,de Bundesliga,21,2000,2.5,2,1,1,1,0,2,8,25.0,6,1,0,1,5,7,3,0,Matches,6bba916f
1273,Luis Javier Suárez,co COL,FW,Granada,es La Liga,23,1997,31.6,26,14,9,9,8,8,27,29.6,19,25,3,22,6,32,23,0,Matches,eeba07f8
1274,Corentin Jean,fr FRA,FWMF,Lens,fr Ligue 1,26,1995,2.8,9,6,4,4,1,3,6,50.0,3,5,0,5,1,10,0,0,Matches,7d9b37bf
1275,Jemerson,br BRA,DF,Metz,fr Ligue 1,28,1992,13.4,37,25,30,7,0,18,26,69.2,8,23,8,15,25,62,33,1,Matches,7cab69b5
1276,Fredrik Jensen,fi FIN,MFFW,Augsburg,de Bundesliga,23,1997,4.6,5,4,1,3,1,4,7,57.1,3,5,1,4,2,7,4,0,Matches,3eeb80e0
1277,Mathias Jensen,dk DEN,MF,Brentford,eng Premier League,25,1996,17.8,33,18,12,16,5,22,63,34.9,41,32,3,29,22,55,13,0,Matches,0f134faf
1278,Moritz Jenz,de GER,DF,Lorient,fr Ligue 1,22,1999,15.3,26,12,18,6,2,11,24,45.8,13,19,11,8,28,54,55,0,Matches,ee644761
1279,Gabriel Jesus,br BRA,FW,Manchester City,eng Premier League,24,1997,20.9,18,12,2,4,12,6,26,23.1,20,18,0,18,15,33,8,0,Matches,b66315ae
1280,Juan Jesus,br BRA,DF,Napoli,it Serie A,30,1991,14.2,25,17,14,11,0,12,18,66.7,6,21,16,5,9,34,34,0,Matches,79083382
1281,Álvaro Jiménez,es ESP,MFFW,Cádiz,es La Liga,26,1995,2.6,6,3,3,2,1,4,7,57.1,3,3,0,3,3,9,0,0,Matches,5f5501ed
1282,Raúl Jiménez,mx MEX,FW,Wolves,eng Premier League,30,1991,29.2,29,14,6,16,7,6,30,20.0,24,31,5,26,13,42,26,0,Matches,b561db50
1283,João Pedro,br BRA,FWMF,Watford,eng Premier League,19,2001,18.3,20,14,7,8,5,6,23,26.1,17,23,3,20,15,35,17,0,Matches,e8832875
1284,Joaquín,es ESP,MF,Betis,es La Liga,40,1981,5.2,6,2,4,2,0,3,8,37.5,5,5,2,3,3,9,10,0,Matches,4c5b14d2
1285,Joelinton,br BRA,MFFW,Newcastle Utd,eng Premier League,24,1996,28.4,72,38,30,33,9,26,61,42.6,35,47,11,36,34,106,50,2,Matches,c17bfb65
1286,Jofre,es ESP,MFDF,Espanyol,es La Liga,20,2001,0.2,1,1,0,0,1,1,1,100.0,0,0,0,0,0,1,0,0,Matches,030ef8d6
1287,Marco John,de GER,DF,Hoffenheim,de Bundesliga,19,2002,0.5,0,0,0,0,0,0,1,0.0,1,1,0,1,1,1,1,0,Matches,d9e196bf
1288,Dennis Johnsen,no NOR,FWMF,Venezia,it Serie A,23,1998,16.1,14,10,8,4,2,6,18,33.3,12,14,1,13,5,19,3,0,Matches,66784dee
1289,Ben Johnson,eng ENG,DF,West Ham,eng Premier League,21,2000,15.5,33,16,15,15,3,21,28,75.0,7,16,8,8,22,55,55,0,Matches,9319781b
1290,Curtis Jones,eng ENG,MF,Liverpool,eng Premier League,20,2001,9.5,11,9,3,6,2,1,10,10.0,9,4,0,4,6,17,4,0,Matches,4fb9c88f
1291,Phil Jones,eng ENG,DF,Manchester Utd,eng Premier League,29,1992,1.8,5,5,3,1,1,2,3,66.7,1,4,4,0,3,8,8,0,Matches,def899bd
1292,Frenkie de Jong,nl NED,MF,Barcelona,es La Liga,24,1997,27.5,35,19,12,18,5,12,23,52.2,11,19,5,14,20,55,16,0,Matches,1bacc518
1293,Luuk de Jong,nl NED,FW,Barcelona,es La Liga,30,1990,7.3,9,7,1,5,3,1,2,50.0,1,4,0,4,0,9,12,0,Matches,abb3bb95
1294,Joan Jordán,es ESP,MF,Sevilla,es La Liga,27,1994,27.9,61,30,22,31,8,28,65,43.1,37,27,6,21,30,91,18,1,Matches,2a0c8ba4
1295,Kaio Jorge,br BRA,MFFW,Juventus,it Serie A,19,2002,1.3,2,1,0,2,0,1,3,33.3,2,1,0,1,0,2,2,0,Matches,0cf465f2
1296,Jorginho,it ITA,MF,Chelsea,eng Premier League,29,1991,25.3,64,33,27,31,6,29,83,34.9,54,27,4,23,36,100,21,1,Matches,45db685d
1297,Josan,es ESP,DFMF,Elche,es La Liga,31,1989,13.5,36,22,23,9,4,26,44,59.1,18,11,4,7,10,46,21,0,Matches,5b28b2f6
1298,Willian José,br BRA,FW,Betis,es La Liga,29,1991,17.8,15,13,2,10,3,2,8,25.0,6,10,2,8,3,18,16,0,Matches,d87e2cae
1299,Joselu,es ESP,FW,Alavés,es La Liga,31,1990,34.7,16,11,1,9,6,7,25,28.0,18,21,4,17,7,23,45,0,Matches,6265208f
1300,Josema,es ESP,DF,Elche,es La Liga,25,1996,2.0,3,2,1,1,1,0,2,0.0,2,1,1,0,0,3,11,0,Matches,ed3f5f4c
1301,Lenny Joseph,fr FRA,FWMF,Metz,fr Ligue 1,20,2000,1.7,2,1,1,1,0,0,0,,0,3,0,3,0,2,0,0,Matches,d1828392
1302,Diogo Jota,pt POR,FW,Liverpool,eng Premier League,24,1996,26.3,39,18,12,18,9,13,55,23.6,42,19,2,17,6,45,6,0,Matches,178ae8f8
1303,Stevan Jovetić,me MNE,FWMF,Hertha BSC,de Bundesliga,31,1989,11.3,5,2,0,2,3,1,6,16.7,5,3,0,3,1,6,6,0,Matches,f36c432f
1304,Luka Jović,rs SRB,FW,Real Madrid,es La Liga,23,1997,4.1,1,1,0,1,0,0,1,0.0,1,3,0,3,1,2,4,0,Matches,4d8cd038
1305,Miguel Juan Llambrich,es ESP,DF,Espanyol,es La Liga,25,1996,0.8,2,2,1,1,0,0,0,,0,1,0,1,0,2,5,0,Matches,d83f09ff
1306,José Juan Macías,mx MEX,FWMF,Getafe,es La Liga,21,1999,2.2,1,0,0,0,1,0,1,0.0,1,1,0,1,1,2,0,0,Matches,1f1c8a15
1307,Juanmi,es ESP,MF,Betis,es La Liga,28,1993,23.7,39,25,11,19,9,19,49,38.8,30,24,1,23,9,48,10,1,Matches,84399660
1308,Gideon Jung,de GER,DF,Greuther Fürth,de Bundesliga,26,1994,1.6,3,1,1,2,0,2,4,50.0,2,1,1,0,2,5,5,0,Matches,a2e7de6f
1309,Flavio Junior Bianchi,it ITA,FWMF,Genoa,it Serie A,21,2000,3.5,2,2,1,0,1,0,2,0.0,2,0,0,0,0,2,0,0,Matches,3ef965c1
1310,Lago Junior,ci CIV,MFFW,Mallorca,es La Liga,30,1990,2.0,3,2,3,0,0,3,5,60.0,2,0,0,0,2,5,2,0,Matches,360d70f8
1311,Hamed Junior Traorè,ci CIV,MF,Sassuolo,it Serie A,21,2000,19.7,32,18,8,14,10,10,46,21.7,36,22,2,20,12,44,6,1,Matches,570bb4b9
1312,Vinicius Júnior,br BRA,FWMF,Real Madrid,es La Liga,21,2000,29.9,46,24,23,19,4,15,50,30.0,35,25,0,25,6,52,6,0,Matches,7111d552
1313,James Justin,eng ENG,DF,Leicester City,eng Premier League,23,1998,11.1,22,13,11,8,3,7,15,46.7,8,16,4,12,17,39,34,0,Matches,fb614c44
1314,Jutglà,es ESP,FW,Barcelona,es La Liga,22,1999,3.3,2,1,0,1,1,0,1,0.0,1,2,0,2,1,3,1,0,Matches,2a9f6b4d
1315,Jens Jønsson,dk DEN,MF,Cádiz,es La Liga,28,1993,14.5,40,29,22,17,1,17,35,48.6,18,17,7,10,34,74,32,0,Matches,53520a67
1316,Mathias Jørgensen,dk DEN,DF,Brentford,eng Premier League,31,1990,5.8,10,4,3,5,2,7,10,70.0,3,6,1,5,10,20,13,0,Matches,0db5d2c8
1317,Ozan Kabak,tr TUR,DF,Norwich City,eng Premier League,21,2000,10.2,10,5,4,6,0,5,9,55.6,4,19,11,8,16,26,26,0,Matches,2d61d13a
1318,Christian Kabasele,be BEL,DF,Watford,eng Premier League,30,1991,13.3,11,5,10,1,0,7,10,70.0,3,20,16,4,14,25,67,1,Matches,914ab9a1
1319,Issa Kaboré,bf BFA,DF,Troyes,fr Ligue 1,20,2001,25.0,45,22,22,14,9,20,38,52.6,18,27,2,25,20,65,38,1,Matches,c066d1a5
1320,Anton Kade,de GER,MFFW,Hertha BSC,de Bundesliga,17,2004,0.9,4,2,3,1,0,2,8,25.0,6,3,0,3,3,7,1,0,Matches,6d7598d5
1321,Pavel Kadeřábek,cz CZE,DFMF,Hoffenheim,de Bundesliga,29,1992,13.3,11,10,6,3,2,5,16,31.3,11,18,6,12,13,24,22,0,Matches,79c90e45
1322,Tino Kadewere,zw ZIM,MFFW,Lyon,fr Ligue 1,25,1996,5.6,7,5,2,2,3,4,13,30.8,9,7,0,7,4,11,1,1,Matches,7d08063d
1323,Florian Kainz,at AUT,MF,Köln,de Bundesliga,28,1992,25.8,41,26,9,25,7,23,51,45.1,28,27,3,24,32,73,24,0,Matches,94c18565
1324,Gaël Kakuta,cd COD,MFFW,Lens,fr Ligue 1,30,1991,18.6,22,14,2,13,7,4,20,20.0,16,10,0,10,4,26,3,0,Matches,5b1bf5e3
1325,Sasa Kalajdzic,at AUT,FW,Stuttgart,de Bundesliga,24,1997,13.6,10,6,2,5,3,3,11,27.3,8,5,0,5,2,12,14,0,Matches,15f24fe7
1326,Arnaud Kalimuendo,fr FRA,FW,Paris S-G,fr Ligue 1,19,2002,0.1,0,0,0,0,0,0,0,,0,0,0,0,0,0,0,0,Matches,bf4c41f9
1327,Arnaud Kalimuendo,fr FRA,FW,Lens,fr Ligue 1,19,2002,23.9,9,8,1,3,5,2,7,28.6,5,6,1,5,8,17,0,0,Matches,bf4c41f9
1328,Nikola Kalinić,hr CRO,FW,Hellas Verona,it Serie A,33,1988,4.5,2,0,0,1,1,1,2,50.0,1,2,0,2,0,2,2,0,Matches,d4931a5a
1329,Yayah Kallon,sl SLE,MFFW,Genoa,it Serie A,20,2001,7.1,15,11,5,6,4,3,11,27.3,8,7,1,6,1,16,5,0,Matches,f95f49d2
1330,Felix Kalu Nmecha,de GER,MFFW,Wolfsburg,de Bundesliga,20,2000,3.6,3,1,1,1,1,0,2,0.0,2,2,0,2,7,10,6,0,Matches,091c86e2
1331,Samuel Kalu,ng NGA,FW,Watford,eng Premier League,23,1997,2.5,2,2,0,2,0,1,1,100.0,0,2,0,2,3,5,3,0,Matches,b8d22478
1332,Samuel Kalu,ng NGA,MFFW,Bordeaux,fr Ligue 1,23,1997,3.6,8,5,3,4,1,2,5,40.0,3,2,0,2,3,11,1,0,Matches,b8d22478
1333,Pierre Kalulu,fr FRA,DF,Milan,it Serie A,21,2000,21.6,61,36,36,21,4,17,22,77.3,5,36,15,21,26,87,54,0,Matches,85f7d1be
1334,Daichi Kamada,jp JPN,MF,Eint Frankfurt,de Bundesliga,24,1996,23.8,40,21,7,26,7,11,40,27.5,29,18,0,18,8,48,10,0,Matches,15b287da
1335,Boubacar Kamara,fr FRA,MFDF,Marseille,fr Ligue 1,21,1999,30.9,68,38,27,36,5,26,47,55.3,21,29,10,19,46,114,44,1,Matches,cc77354e
1336,Hassane Kamara,ci CIV,DF,Watford,eng Premier League,27,1994,18.0,53,34,31,16,6,27,43,62.8,16,20,4,16,69,122,67,0,Matches,19a12bed
1337,Hassane Kamara,ci CIV,MFDF,Nice,fr Ligue 1,27,1994,6.0,13,10,4,6,3,5,8,62.5,3,10,2,8,9,22,4,0,Matches,19a12bed
1338,Dimitrije Kamenović,rs SRB,DF,Lazio,it Serie A,21,2000,0.5,1,1,1,0,0,1,1,100.0,0,0,0,0,2,3,1,0,Matches,d3e0c826
1339,Kevin Kampl,si SVN,MF,RB Leipzig,de Bundesliga,30,1990,21.1,41,19,16,20,5,10,42,23.8,32,24,5,19,24,65,17,0,Matches,b825a650
1340,Jean-Armel Kana-Biyik,cm CMR,DF,Metz,fr Ligue 1,32,1989,7.4,10,6,8,2,0,4,9,44.4,5,11,4,7,16,26,22,1,Matches,76a4233b
1341,Nordine Kandil,fr FRA,MFFW,Strasbourg,fr Ligue 1,19,2001,1.0,2,1,2,0,0,1,1,100.0,0,1,1,0,0,2,0,0,Matches,c5908bc4
1342,Harry Kane,eng ENG,FW,Tottenham,eng Premier League,28,1993,35.9,15,5,2,10,3,7,18,38.9,11,26,8,18,3,18,39,0,Matches,21a66f6a
1343,Lee Kangin,kr KOR,MFFW,Mallorca,es La Liga,20,2001,15.7,13,6,2,9,2,5,29,17.2,24,11,1,10,5,18,7,0,Matches,8455ad90
1344,N'Golo Kanté,fr FRA,MF,Chelsea,eng Premier League,30,1991,19.7,59,31,20,27,12,25,40,62.5,15,37,2,35,31,90,8,0,Matches,b9fbae28
1345,Stefanos Kapino,gr GRE,GK,Arminia,de Bundesliga,27,1994,1.0,0,0,0,0,0,0,0,,0,0,0,0,0,0,0,0,Matches,62ba5881
1346,Atakan Karazor,de GER,MF,Stuttgart,de Bundesliga,24,1996,21.1,48,24,18,27,3,18,36,50.0,18,37,14,23,34,82,47,0,Matches,5762be5c
1347,Rick Karsdorp,nl NED,DFFW,Roma,it Serie A,26,1995,32.0,53,38,33,13,7,28,50,56.0,22,22,5,17,34,87,26,1,Matches,9f84febe
1348,Denso Kasius,nl NED,DFFW,Bologna,it Serie A,18,2002,2.0,8,6,4,3,1,2,5,40.0,3,4,0,4,3,11,4,0,Matches,7ae36711
1349,Grigoris Kastanos,cy CYP,MF,Salernitana,it Serie A,23,1998,15.0,30,19,9,19,2,7,23,30.4,16,21,5,16,22,52,8,0,Matches,2a82aa85
1350,Silas Katompa,cd COD,FWMF,Stuttgart,de Bundesliga,22,1998,3.1,5,4,4,0,1,3,7,42.9,4,5,0,5,2,7,1,0,Matches,de4cac2d
1351,Noah Katterbach,de GER,DF,Köln,de Bundesliga,20,2001,0.2,1,1,1,0,0,1,1,100.0,0,0,0,0,0,1,1,0,Matches,e27de4fa
1352,Eiji Kawashima,jp JPN,GK,Strasbourg,fr Ligue 1,38,1983,1.0,0,0,0,0,0,0,0,,0,0,0,0,0,0,0,0,Matches,a4527d33
1353,Edo Kayembe,cd COD,MF,Watford,eng Premier League,23,1998,8.9,21,13,11,9,1,8,16,50.0,8,6,1,5,9,30,13,0,Matches,f99b71de
1354,Moise Kean,it ITA,FW,Everton,eng Premier League,21,2000,0.0,0,0,0,0,0,0,0,,0,0,0,0,0,0,0,0,Matches,3d50bcdb
1355,Moise Kean,it ITA,FW,Juventus,it Serie A,21,2000,12.2,9,4,2,5,2,6,16,37.5,10,5,0,5,3,12,8,1,Matches,3d50bcdb
1356,Michael Keane,eng ENG,DF,Everton,eng Premier League,28,1993,31.0,46,25,32,13,1,28,45,62.2,17,33,28,5,62,108,128,2,Matches,c5b7c315
1357,Ilan Kebbal,dz ALG,MFFW,Reims,fr Ligue 1,23,1998,19.7,31,15,13,10,8,12,44,27.3,32,16,0,16,13,44,3,0,Matches,37d04e90
1358,Wajdi Kechrida,tn TUN,DFMF,Salernitana,it Serie A,25,1995,10.6,9,6,6,3,0,8,13,61.5,5,10,2,8,8,17,15,0,Matches,11962fe7
1359,Thilo Kehrer,de GER,DF,Paris S-G,fr Ligue 1,24,1996,16.8,21,14,9,11,1,9,21,42.9,12,19,11,8,24,45,29,0,Matches,51dbeea9
1360,Habib Keita,ml MLI,MF,Lyon,fr Ligue 1,19,2002,0.1,0,0,0,0,0,0,0,,0,0,0,0,0,0,0,0,Matches,cc588cbe
1361,Naby Keïta,gn GUI,MF,Liverpool,eng Premier League,26,1995,13.0,46,23,17,19,10,26,42,61.9,16,33,2,31,14,60,8,0,Matches,f25c8e3a
1362,Yannik Keitel,de GER,MF,Freiburg,de Bundesliga,21,2000,5.6,11,4,5,4,2,5,15,33.3,10,7,1,6,1,12,8,0,Matches,d2c580ce
1363,Caoimhín Kelleher,ie IRL,GK,Liverpool,eng Premier League,22,1998,2.0,1,1,1,0,0,1,1,100.0,0,0,0,0,0,1,1,0,Matches,62d7ef38
1364,Marc-Oliver Kempf,de GER,DF,Hertha BSC,de Bundesliga,26,1995,11.7,10,9,9,1,0,5,14,35.7,9,14,7,7,25,35,49,1,Matches,815c314f
1365,Marc-Oliver Kempf,de GER,DF,Stuttgart,de Bundesliga,26,1995,9.3,13,8,7,4,2,3,10,30.0,7,16,14,2,16,29,26,2,Matches,815c314f
1366,Kenedy,br BRA,DF,Chelsea,eng Premier League,25,1996,0.6,5,2,1,2,2,2,3,66.7,1,0,0,0,0,5,0,0,Matches,5eebbfdf
1367,Jonjoe Kenny,eng ENG,DF,Everton,eng Premier League,24,1997,11.3,17,7,11,6,0,13,21,61.9,8,8,1,7,20,37,31,0,Matches,099e666f
1368,Dimitrios Keramitsis,gr GRE,MF,Roma,it Serie A,17,2004,0.0,0,0,0,0,0,0,0,,0,0,0,0,0,0,0,0,Matches,6f30a1d5
1369,Franck Kessié,ci CIV,MF,Milan,it Serie A,24,1996,25.6,41,23,12,24,5,17,26,65.4,9,39,10,29,23,64,22,0,Matches,05e19d6a
1370,Saîf-Eddine Khaoui,tn TUN,MF,Clermont Foot,fr Ligue 1,26,1995,10.3,19,10,5,10,4,9,18,50.0,9,9,0,9,14,33,5,0,Matches,796b1c41
1371,Wahbi Khazri,tn TUN,FWMF,Saint-Étienne,fr Ligue 1,30,1991,24.7,33,18,7,17,9,9,34,26.5,25,21,0,21,12,45,7,0,Matches,2677a1de
1372,Rani Khedira,de GER,MF,Union Berlin,de Bundesliga,27,1994,30.6,75,38,25,42,8,32,66,48.5,34,21,8,13,50,125,27,1,Matches,59e4b92e
1373,Kike,es ESP,FW,Osasuna,es La Liga,31,1989,20.7,11,7,3,4,4,3,23,13.0,20,10,1,9,3,14,12,0,Matches,e897d8ba
1374,Luca Kilian,de GER,FW,Mainz 05,de Bundesliga,21,1999,0.0,0,0,0,0,0,0,0,,0,0,0,0,0,0,0,0,Matches,610aa1e9
1375,Luca Kilian,de GER,DF,Köln,de Bundesliga,21,1999,25.3,42,24,30,9,3,21,41,51.2,20,31,13,18,46,88,109,3,Matches,610aa1e9
1376,Max Kilman,eng ENG,DF,Wolves,eng Premier League,24,1997,29.9,50,26,38,10,2,24,37,64.9,13,36,21,15,45,95,113,3,Matches,d0f72bf1
1377,Joshua Kimmich,de GER,MF,Bayern Munich,de Bundesliga,26,1995,27.5,39,20,14,17,8,18,58,31.0,40,34,8,26,52,91,29,1,Matches,49296448
1378,Presnel Kimpembe,fr FRA,DF,Paris S-G,fr Ligue 1,25,1995,28.6,34,19,18,15,1,14,23,60.9,9,20,14,6,38,72,73,1,Matches,aef6e670
1379,Joshua King,no NOR,FWMF,Watford,eng Premier League,29,1992,25.0,19,15,7,6,6,4,17,23.5,13,15,4,11,8,27,31,0,Matches,43458538
1380,Jakub Kiwior,pl POL,MF,Spezia,it Serie A,21,2000,21.8,50,27,25,19,6,26,57,45.6,31,38,15,23,40,90,53,0,Matches,dc3e663e
1381,Sofian Kiyine,ma MAR,MFFW,Venezia,it Serie A,23,1997,13.8,24,14,9,11,4,12,32,37.5,20,15,1,14,10,34,9,0,Matches,ce1806be
1382,Simon Kjær,dk DEN,DF,Milan,it Serie A,32,1989,8.9,20,12,9,8,3,6,12,50.0,6,17,13,4,9,29,39,0,Matches,8b8a56ce
1383,Kristoffer Klaesson,no NOR,GK,Leeds United,eng Premier League,20,2000,0.4,0,0,0,0,0,0,0,,0,0,0,0,0,0,0,0,Matches,3f70db80
1384,Philipp Klement,de GER,MF,Stuttgart,de Bundesliga,28,1992,3.8,7,3,1,4,2,3,3,100.0,0,6,1,5,1,8,0,0,Matches,0cddeaa7
1385,Mateusz Klich,pl POL,MF,Leeds United,eng Premier League,31,1990,23.0,47,25,18,23,6,25,66,37.9,41,22,4,18,11,58,20,0,Matches,282679b4
1386,Thibault Klidje,tg TOG,MFFW,Bordeaux,fr Ligue 1,20,2001,1.0,0,0,0,0,0,0,1,0.0,1,1,1,0,2,2,0,0,Matches,db013c7d
1387,Mateo Klimowicz,de GER,MFFW,Stuttgart,de Bundesliga,21,2000,6.7,13,6,6,7,0,5,16,31.3,11,2,0,2,4,17,3,0,Matches,2b7c56b4
1388,Fabian Klos,de GER,FW,Arminia,de Bundesliga,33,1987,15.8,7,5,0,5,2,2,10,20.0,8,17,4,13,0,7,31,0,Matches,e21042ae
1389,Lukas Klostermann,de GER,DF,RB Leipzig,de Bundesliga,25,1996,18.3,29,16,11,15,3,13,19,68.4,6,16,3,13,26,55,58,0,Matches,ca8033cb
1390,Justin Kluivert,nl NED,MF,Nice,fr Ligue 1,22,1999,20.8,19,9,6,12,1,5,21,23.8,16,13,1,12,14,33,6,0,Matches,4c3a6744
1391,Lukas Klünter,de GER,DF,Hertha BSC,de Bundesliga,25,1996,2.2,1,1,1,0,0,1,5,20.0,4,1,0,1,2,3,2,0,Matches,92948149
1392,Ansgar Knauff,de GER,MF,Dortmund,de Bundesliga,19,2002,1.3,3,1,1,1,1,0,4,0.0,4,2,0,2,0,3,4,0,Matches,19a967ab
1393,Ansgar Knauff,de GER,DFMF,Eint Frankfurt,de Bundesliga,19,2002,8.4,18,14,8,5,5,8,15,53.3,7,11,1,10,8,26,6,0,Matches,19a967ab
1394,Robin Knoche,de GER,DF,Union Berlin,de Bundesliga,29,1992,33.0,50,24,38,12,0,30,53,56.6,23,45,26,19,49,99,151,1,Matches,6bd5cd5d
1395,Gregor Kobel,ch SUI,GK,Dortmund,de Bundesliga,23,1997,28.5,0,0,0,0,0,0,2,0.0,2,0,0,0,1,1,20,0,Matches,cd59b9df
1396,Robin Koch,de GER,MFDF,Leeds United,eng Premier League,25,1996,17.5,21,13,9,10,2,9,34,26.5,25,26,10,16,20,41,44,0,Matches,ea6bc03a
1397,Samuel Koeberlé,fr FRA,FW,Reims,fr Ligue 1,16,2004,0.0,0,0,0,0,0,0,0,,0,0,0,0,0,0,0,0,Matches,6751b938
1398,Philippe Koffi,fr FRA,FW,Reims,fr Ligue 1,19,2002,4.2,4,0,0,3,1,0,2,0.0,2,2,1,1,3,7,3,0,Matches,9f1c2822
1399,Dominik Kohr,de GER,MF,Mainz 05,de Bundesliga,27,1994,17.9,40,20,18,19,3,16,42,38.1,26,21,2,19,35,75,22,0,Matches,0fbecd11
1400,Koba Koindredi,fr FRA,MF,Valencia,es La Liga,19,2001,2.0,4,3,2,1,1,2,6,33.3,4,3,0,3,4,8,5,0,Matches,3a58d075
1401,Koke,es ESP,MF,Atlético Madrid,es La Liga,29,1992,27.9,55,30,19,29,7,26,63,41.3,37,21,5,16,24,79,31,1,Matches,55126f3b
1402,Aleksandr Kokorin,ru RUS,FWMF,Fiorentina,it Serie A,30,1991,0.6,1,1,1,0,0,0,0,,0,1,0,1,0,1,0,0,Matches,fec5accc
1403,Aleksandar Kolarov,rs SRB,DF,Inter,it Serie A,35,1985,0.5,1,1,1,0,0,1,1,100.0,0,0,0,0,1,2,2,0,Matches,eda40760
1404,Sead Kolašinac,ba BIH,DF,Arsenal,eng Premier League,28,1993,1.0,0,0,0,0,0,0,0,,0,0,0,0,4,4,1,0,Matches,3935e52e
1405,Sead Kolašinac,ba BIH,DF,Marseille,fr Ligue 1,28,1993,4.9,7,6,2,3,2,5,8,62.5,3,4,0,4,0,7,7,1,Matches,3935e52e
1406,Luca Koleosho,ca CAN,FW,Espanyol,es La Liga,16,2004,0.0,0,0,0,0,0,0,0,,0,0,0,0,0,0,0,0,Matches,fc076f78
1407,Randal Kolo Muani,fr FRA,FWMF,Nantes,fr Ligue 1,22,1998,32.8,28,14,7,10,11,10,25,40.0,15,14,3,11,6,34,31,0,Matches,c0b3669f
1408,Timothée Kolodziejczak,fr FRA,DF,Saint-Étienne,fr Ligue 1,29,1991,28.5,43,24,22,14,7,20,36,55.6,16,29,7,22,60,103,72,1,Matches,ab096c6f
1409,Ghislain Konan,ci CIV,DF,Reims,fr Ligue 1,25,1995,26.9,35,19,19,15,1,16,30,53.3,14,35,8,27,28,63,45,0,Matches,6b2c894b
1410,Ibrahima Konaté,fr FRA,DF,Liverpool,eng Premier League,22,1999,11.0,16,10,9,6,1,7,10,70.0,3,13,9,4,16,32,37,1,Matches,5ed9b537
1411,Geoffrey Kondogbia,cf CTA,MFDF,Atlético Madrid,es La Liga,28,1993,20.9,74,44,25,40,9,21,49,42.9,28,16,5,11,44,118,24,0,Matches,cce181df
1412,Ibrahima Koné,ml MLI,FW,Lorient,fr Ligue 1,22,1999,8.1,7,4,0,3,4,2,3,66.7,1,8,3,5,1,8,3,0,Matches,04bb2b06
1413,Kouadio Koné,fr FRA,MF,M'Gladbach,de Bundesliga,20,2001,24.3,68,35,31,34,3,29,46,63.0,17,28,5,23,34,102,14,0,Matches,86574238
1414,Youssouf Koné,ml MLI,DF,Troyes,fr Ligue 1,26,1995,10.9,30,18,21,8,1,19,30,63.3,11,8,3,5,10,40,25,0,Matches,e6eadfb8
1415,Ezri Konsa,eng ENG,DF,Aston Villa,eng Premier League,23,1997,27.5,25,15,13,11,1,10,13,76.9,3,31,22,9,15,40,86,2,Matches,0313a347
1416,Teun Koopmeiners,nl NED,MF,Atalanta,it Serie A,23,1998,23.6,40,24,10,19,11,22,54,40.7,32,31,2,29,15,55,19,0,Matches,a26fb8aa
1417,Laurent Koscielny,fr FRA,DF,Bordeaux,fr Ligue 1,35,1985,10.4,14,9,10,3,1,8,13,61.5,5,17,12,5,12,26,39,0,Matches,f5efb153
1418,Odilon Kossonou,ci CIV,DF,Leverkusen,de Bundesliga,20,2001,19.9,23,17,16,6,1,15,25,60.0,10,36,14,22,26,49,66,0,Matches,1f3afdcb
1419,Filip Kostić,rs SRB,DFMF,Eint Frankfurt,de Bundesliga,28,1992,28.0,44,17,26,9,9,20,53,37.7,33,24,1,23,15,59,24,0,Matches,b1cd37e6
1420,Rominigue Kouamé,ml MLI,MF,Troyes,fr Ligue 1,24,1996,33.0,47,22,24,20,3,19,58,32.8,39,33,5,28,46,93,22,2,Matches,86a2ba20
1421,Kalidou Koulibaly,sn SEN,DF,Napoli,it Serie A,30,1991,26.7,39,23,31,6,2,25,38,65.8,13,41,25,16,29,68,90,1,Matches,da974c7b
1422,Jules Koundé,fr FRA,DF,Sevilla,es La Liga,22,1998,30.4,40,17,27,10,3,18,28,64.3,10,33,18,15,21,61,101,2,Matches,4d1666ff
1423,Christos Kourfalidis,gr GRE,MFFW,Cagliari,it Serie A,18,2002,0.2,0,0,0,0,0,0,1,0.0,1,1,0,1,0,0,0,0,Matches,5c522c88
1424,Boubakar Kouyaté,ml MLI,DF,Metz,fr Ligue 1,24,1997,29.6,84,50,56,28,0,48,77,62.3,29,63,33,30,79,163,217,3,Matches,562a4799
1425,Cheikhou Kouyaté,sn SEN,MF,Crystal Palace,eng Premier League,31,1989,21.9,52,38,28,22,2,18,39,46.2,21,40,14,26,38,90,39,0,Matches,8d3c902d
1426,Mateo Kovačić,hr CRO,MF,Chelsea,eng Premier League,27,1994,17.3,51,31,14,26,11,17,35,48.6,18,19,4,15,7,58,9,1,Matches,79c0821a
1427,Viktor Kovalenko,ua UKR,MF,Spezia,it Serie A,25,1996,14.7,16,10,7,8,1,9,21,42.9,12,16,3,13,13,29,8,0,Matches,9d60028d
1428,Emil Krafth,se SWE,DF,Newcastle Utd,eng Premier League,26,1994,18.2,37,16,25,11,1,27,36,75.0,9,16,10,6,25,62,56,0,Matches,77cf6852
1429,Alex Král,cz CZE,MF,West Ham,eng Premier League,23,1998,0.0,0,0,0,0,0,0,0,,0,0,0,0,0,0,0,0,Matches,e717705a
1430,Andrej Kramarić,hr CRO,FWMF,Hoffenheim,de Bundesliga,30,1991,30.1,8,4,1,5,2,7,17,41.2,10,10,0,10,9,17,7,1,Matches,603cb947
1431,Christoph Kramer,de GER,MF,M'Gladbach,de Bundesliga,30,1991,8.3,28,11,15,10,3,12,28,42.9,16,18,5,13,12,40,9,0,Matches,496aeede
1432,Jean-Philippe Krasso,ci CIV,FWMF,Saint-Étienne,fr Ligue 1,24,1997,5.0,7,5,0,5,2,2,10,20.0,8,7,1,6,0,7,1,0,Matches,037f2523
1433,Julian Kristoffersen,no NOR,FW,Salernitana,it Serie A,24,1997,0.1,0,0,0,0,0,0,0,,0,0,0,0,0,0,0,0,Matches,b804c280
1434,Toni Kroos,de GER,MF,Real Madrid,es La Liga,31,1990,23.4,34,26,13,17,4,14,36,38.9,22,16,3,13,12,46,13,1,Matches,6ce1f46f
1435,Florian Krüger,de GER,MFFW,Arminia,de Bundesliga,22,1999,12.5,3,1,0,3,0,2,10,20.0,8,12,1,11,2,5,13,0,Matches,f9f92b5f
1436,Tim Krul,nl NED,GK,Norwich City,eng Premier League,33,1988,29.0,1,1,1,0,0,1,4,25.0,3,0,0,0,0,1,10,4,Matches,f23f9d20
1437,Rade Krunić,ba BIH,MF,Milan,it Serie A,27,1993,15.7,33,18,16,14,3,15,31,48.4,16,19,2,17,16,49,17,0,Matches,817c6964
1438,Max Kruse,de GER,MFFW,Wolfsburg,de Bundesliga,33,1988,12.5,9,3,4,4,1,5,12,41.7,7,2,0,2,3,12,4,0,Matches,f9446dcd
1439,Max Kruse,de GER,FWMF,Union Berlin,de Bundesliga,33,1988,14.1,4,1,0,3,1,2,16,12.5,14,12,0,12,3,7,2,0,Matches,f9446dcd
1440,Lukas Kübler,de GER,DFMF,Freiburg,de Bundesliga,28,1992,25.9,62,35,38,16,8,28,49,57.1,21,24,8,16,44,106,70,0,Matches,2a29eb9b
1441,Takefusa Kubo,jp JPN,MFFW,Mallorca,es La Liga,20,2001,17.8,31,19,12,14,5,10,24,41.7,14,24,3,21,8,39,4,0,Matches,16aa3654
1442,Juraj Kucka,sk SVK,MF,Watford,eng Premier League,34,1987,21.3,59,39,32,25,2,27,73,37.0,46,30,9,21,27,86,46,2,Matches,5aaef9ef
1443,Mykola Kukharevych,ua UKR,FW,Troyes,fr Ligue 1,20,2001,0.2,0,0,0,0,0,0,0,,0,0,0,0,0,0,0,0,Matches,8197a269
1444,Dejan Kulusevski,se SWE,MFFW,Tottenham,eng Premier League,21,2000,14.0,19,13,7,10,2,5,23,21.7,18,14,0,14,13,32,3,0,Matches,df3cda47
1445,Dejan Kulusevski,se SWE,MFFW,Juventus,it Serie A,21,2000,8.6,15,12,9,6,0,8,21,38.1,13,14,0,14,5,20,5,0,Matches,df3cda47
1446,Marash Kumbulla,al ALB,DF,Roma,it Serie A,21,2000,11.4,21,13,13,7,1,8,15,53.3,7,17,8,9,16,37,26,0,Matches,a40819d9
1447,Fabian Kunze,de GER,MF,Arminia,de Bundesliga,23,1998,14.0,35,21,14,20,1,15,32,46.9,17,17,2,15,19,54,27,1,Matches,d25fee56
1448,Enock Kwateng,fr FRA,DF,Bordeaux,fr Ligue 1,24,1997,22.2,54,35,31,19,4,33,72,45.8,39,17,4,13,43,97,48,1,Matches,4bf69118
1449,Grejohn Kyei,fr FRA,FW,Clermont Foot,fr Ligue 1,25,1995,4.4,3,2,1,1,1,0,6,0.0,6,6,0,6,0,3,1,0,Matches,397ba086
1450,Giorgos Kyriakopoulos,gr GRE,DFMF,Sassuolo,it Serie A,25,1996,21.9,30,14,19,7,4,19,38,50.0,19,32,9,23,11,41,52,0,Matches,0a483542
1451,Andrea La Mantia,it ITA,FWMF,Empoli,it Serie A,30,1991,5.4,2,0,0,0,2,1,2,50.0,1,3,1,2,1,3,6,0,Matches,c375dfa5
1452,Gaëtan Laborde,fr FRA,MFFW,Montpellier,fr Ligue 1,27,1994,3.8,2,2,1,1,0,2,4,50.0,2,3,0,3,5,7,5,0,Matches,7cdda3bf
1453,Gaëtan Laborde,fr FRA,FW,Rennes,fr Ligue 1,27,1994,30.3,19,7,5,8,6,3,22,13.6,19,29,3,26,8,27,16,0,Matches,7cdda3bf
1454,Alexandre Lacazette,fr FRA,FW,Arsenal,eng Premier League,30,1991,19.8,27,10,8,13,6,7,21,33.3,14,12,1,11,5,32,6,0,Matches,9dbb75ca
1455,Tom Lacoux,fr FRA,DFMF,Bordeaux,fr Ligue 1,19,2002,10.1,18,13,11,5,2,9,24,37.5,15,14,4,10,9,27,20,1,Matches,295ba708
1456,Lenny Lacroix,fr FRA,DF,Metz,fr Ligue 1,18,2003,2.2,9,7,8,1,0,5,8,62.5,3,5,1,4,10,19,5,0,Matches,5413ef36
1457,Maxence Lacroix,fr FRA,DF,Wolfsburg,de Bundesliga,21,2000,27.7,59,33,41,16,2,29,40,72.5,11,35,16,19,60,119,144,0,Matches,277c49ed
1458,Alban Lafont,fr FRA,GK,Nantes,fr Ligue 1,22,1999,38.0,3,3,3,0,0,3,8,37.5,5,1,0,1,1,4,25,2,Matches,4e7db402
1459,Víctor Laguardia,es ESP,DF,Alavés,es La Liga,31,1989,33.8,29,16,21,8,0,19,30,63.3,11,36,24,12,27,56,151,1,Matches,b7c99b9b
1460,Konrad Laimer,at AUT,MF,RB Leipzig,de Bundesliga,24,1997,13.8,38,24,11,22,5,24,53,45.3,29,29,3,26,4,42,9,0,Matches,c1b7847c
1461,Stefan Lainer,at AUT,DF,M'Gladbach,de Bundesliga,28,1992,16.3,20,11,9,8,3,13,30,43.3,17,24,5,19,14,34,33,0,Matches,4aea5077
1462,Diego Lainez,mx MEX,MF,Betis,es La Liga,21,2000,1.6,1,1,0,1,0,0,3,0.0,3,3,0,3,1,2,0,0,Matches,bf12926c
1463,Adam Lallana,eng ENG,MF,Brighton,eng Premier League,33,1988,17.3,34,17,14,14,6,12,41,29.3,29,16,6,10,16,50,13,1,Matches,99813635
1464,Vassilis Lambropoulos,gr GRE,DF,Bochum,de Bundesliga,31,1990,13.0,18,12,13,3,2,11,25,44.0,14,21,10,11,17,35,56,0,Matches,591477c9
1465,Érik Lamela,ar ARG,FWMF,Sevilla,es La Liga,29,1992,11.3,31,18,12,14,5,10,29,34.5,19,11,0,11,5,36,3,0,Matches,abe66106
1466,Mohamed Lamine Bayo,gn GUI,FW,Clermont Foot,fr Ligue 1,23,1998,26.8,12,5,4,3,5,3,24,12.5,21,7,1,6,7,19,14,0,Matches,01870104
1467,Didier Lamkel Zé,cm CMR,FW,Metz,fr Ligue 1,24,1996,6.7,3,1,1,0,2,1,3,33.3,2,3,1,2,1,4,7,0,Matches,b229aa13
1468,Sam Lammers,nl NED,FWMF,Atalanta,it Serie A,24,1997,0.4,1,0,0,0,1,0,0,,0,0,0,0,0,1,0,0,Matches,c283ddef
1469,Sam Lammers,nl NED,FWMF,Eint Frankfurt,de Bundesliga,24,1997,5.7,4,4,0,2,2,2,6,33.3,4,9,2,7,2,6,4,0,Matches,c283ddef
1470,Tariq Lamptey,gh GHA,DFMF,Brighton,eng Premier League,20,2000,17.3,36,25,14,17,5,15,25,60.0,10,13,3,10,21,57,23,0,Matches,f4e433d4
1471,Manuel Lanzini,ar ARG,MF,West Ham,eng Premier League,28,1993,19.8,28,15,10,11,7,10,35,28.6,25,16,0,16,19,47,10,0,Matches,26f6dca8
1472,Aymeric Laporte,es ESP,DF,Manchester City,eng Premier League,27,1994,31.4,33,15,22,10,1,14,20,70.0,6,15,10,5,20,53,64,2,Matches,119b9a8e
1473,Julien Laporte,fr FRA,DF,Lorient,fr Ligue 1,27,1993,32.1,63,45,35,26,2,32,64,50.0,32,37,22,15,54,117,174,0,Matches,f066022d
1474,Yasser Larouci,dz ALG,DF,Troyes,fr Ligue 1,20,2001,3.8,6,5,2,4,0,3,3,100.0,0,1,0,1,7,13,5,0,Matches,0ed063d6
1475,Kevin Lasagna,it ITA,MFFW,Hellas Verona,it Serie A,28,1992,13.2,13,7,4,5,4,4,15,26.7,11,16,0,16,3,16,7,0,Matches,09538fdb
1476,Jamaal Lascelles,eng ENG,DF,Newcastle Utd,eng Premier League,27,1993,22.9,15,7,9,5,1,4,12,33.3,8,38,28,10,22,37,121,1,Matches,450ab6fc
1477,Bryan Lasme,fr FRA,FWMF,Arminia,de Bundesliga,22,1998,9.7,6,6,1,2,3,0,3,0.0,3,7,0,7,1,7,9,0,Matches,ebac0ace
1478,Paul Lasne,fr FRA,MF,Brest,fr Ligue 1,32,1989,9.4,26,12,6,16,4,8,19,42.1,11,11,2,9,24,50,10,0,Matches,542cc80f
1479,Latasa,es ESP,FW,Real Madrid,es La Liga,20,2001,0.1,0,0,0,0,0,0,0,,0,0,0,0,0,0,0,0,Matches,2bea832e
1480,Toni Lato,es ESP,DF,Valencia,es La Liga,23,1997,6.6,17,12,12,3,2,9,16,56.3,7,6,0,6,8,25,14,0,Matches,8e088e04
1481,Armand Lauriente,fr FRA,FWMF,Lorient,fr Ligue 1,22,1998,27.5,33,18,9,16,8,11,30,36.7,19,27,2,25,15,48,3,0,Matches,2d22cea7
1482,Darko Lazović,rs SRB,DF,Hellas Verona,it Serie A,30,1990,30.7,36,23,20,8,8,21,39,53.8,18,28,4,24,19,55,49,1,Matches,5128bde4
1483,Manuel Lazzari,it ITA,DF,Lazio,it Serie A,27,1993,18.5,28,14,13,15,0,16,26,61.5,10,10,2,8,12,40,16,1,Matches,02caf6e0
1484,Théo Le Bris,fr FRA,MF,Lorient,fr Ligue 1,18,2002,0.7,2,1,1,1,0,1,2,50.0,1,2,0,2,0,2,1,0,Matches,afe39ca8
1485,Jérémy Le Douaron,fr FRA,FWMF,Brest,fr Ligue 1,23,1998,16.1,11,5,4,4,3,1,17,5.9,16,15,0,15,4,15,14,0,Matches,88c4d190
1486,Enzo Le Fée,fr FRA,MFFW,Lorient,fr Ligue 1,21,2000,24.4,70,44,25,36,9,41,90,45.6,49,25,1,24,29,99,18,0,Matches,6f806d99
1487,Vincent Le Goff,fr FRA,DF,Lorient,fr Ligue 1,31,1989,34.0,61,38,38,19,4,37,62,59.7,25,18,3,15,37,98,50,0,Matches,2321ea6e
1488,Maxime Le Marchand,fr FRA,DF,Strasbourg,fr Ligue 1,31,1989,9.6,17,8,16,1,0,8,10,80.0,2,9,5,4,14,31,32,0,Matches,321a71a7
1489,Robin Le Normand,fr FRA,DF,Real Sociedad,es La Liga,24,1996,37.0,49,32,36,8,5,28,36,77.8,8,34,22,12,48,97,125,0,Matches,9a64e67e
1490,Patrick Leal,us USA,FW,Venezia,it Serie A,18,2003,0.0,0,0,0,0,0,0,1,0.0,1,0,0,0,0,0,0,0,Matches,d97ec0d1
1491,Rafael Leão,pt POR,MF,Milan,it Serie A,22,1999,28.9,17,7,3,9,5,10,20,50.0,10,12,1,11,12,29,8,0,Matches,20730eae
1492,Jean-Louis Leca,fr FRA,GK,Lens,fr Ligue 1,35,1985,25.7,0,0,0,0,0,0,0,,0,1,0,1,1,1,11,1,Matches,edbe46dc
1493,Jeremías Ledesma,ar ARG,GK,Cádiz,es La Liga,28,1993,38.0,3,1,3,0,0,3,4,75.0,1,0,0,0,1,4,21,4,Matches,6c4776b1
1494,Pierre Lees-Melou,fr FRA,MF,Norwich City,eng Premier League,28,1993,25.2,58,36,23,29,6,25,92,27.2,67,37,11,26,25,83,23,0,Matches,f5044e54
1495,Wu Lei,cn CHN,MFFW,Espanyol,es La Liga,29,1991,5.3,3,2,1,2,0,3,8,37.5,5,4,0,4,4,7,3,0,Matches,e3fabb0a
1496,Maxim Leitsch,de GER,DF,Bochum,de Bundesliga,23,1998,17.1,18,10,9,7,2,10,15,66.7,5,31,19,12,31,49,74,1,Matches,7e12a98d
1497,Lucas Leiva,br BRA,MF,Lazio,it Serie A,34,1987,18.9,55,30,26,25,4,15,53,28.3,38,27,10,17,28,83,37,0,Matches,4c78b5ed
1498,Florian Lejeune,fr FRA,DF,Alavés,es La Liga,30,1991,30.0,33,24,22,10,1,12,20,60.0,8,30,19,11,31,64,158,0,Matches,6eaed4eb
1499,Iñigo Lekue,es ESP,DF,Athletic Club,es La Liga,28,1993,21.4,32,23,16,12,4,22,44,50.0,22,37,12,25,23,55,63,0,Matches,59b7d823
1500,Thomas Lemar,fr FRA,MF,Atlético Madrid,es La Liga,25,1995,16.0,24,14,9,12,3,8,23,34.8,15,18,0,18,8,32,11,0,Matches,4dbd0916
1501,Félix Lemaréchal,ci CIV,MF,Monaco,fr Ligue 1,17,2003,0.1,0,0,0,0,0,0,1,0.0,1,0,0,0,0,0,0,0,Matches,8ca9415f
1502,Mario Lemina,ga GAB,MF,Nice,fr Ligue 1,27,1993,21.9,62,35,25,33,4,28,38,73.7,10,32,9,23,48,110,37,0,Matches,2b471f99
1503,Fabien Lemoine,fr FRA,MF,Lorient,fr Ligue 1,34,1987,12.4,35,22,20,14,1,17,41,41.5,24,21,4,17,14,49,24,1,Matches,54d51e22
1504,Tim Lemperle,de GER,FWMF,Köln,de Bundesliga,19,2002,1.7,4,1,2,1,1,1,3,33.3,2,1,0,1,2,6,2,0,Matches,792ffa71
1505,Ruben Lendinez,es ESP,DF,Valencia,es La Liga,18,2003,1.5,3,3,1,2,0,3,8,37.5,5,4,0,4,2,5,6,0,Matches,755da865
1506,Clément Lenglet,fr FRA,DF,Barcelona,es La Liga,26,1995,9.2,20,11,11,7,2,8,13,61.5,5,7,3,4,13,33,21,0,Matches,4f28a6ff
1507,Aaron Lennon,eng ENG,MFFW,Burnley,eng Premier League,34,1987,17.2,33,17,10,13,10,10,34,29.4,24,26,4,22,9,42,14,0,Matches,2ff964a0
1508,Bernd Leno,de GER,GK,Arsenal,eng Premier League,29,1992,4.0,1,1,1,0,0,1,1,100.0,0,0,0,0,0,1,1,0,Matches,2628fd2b
1509,Christopher Lenz,de GER,DF,Eint Frankfurt,de Bundesliga,26,1994,7.4,29,15,22,6,1,12,21,57.1,9,9,4,5,7,36,21,0,Matches,bbd86530
1510,Léo Leroy,fr FRA,MF,Montpellier,fr Ligue 1,21,2000,7.0,31,21,17,11,3,12,34,35.3,22,20,4,16,8,39,8,0,Matches,fcc84a07
1511,Alexandre Letellier,fr FRA,GK,Paris S-G,fr Ligue 1,30,1990,0.1,0,0,0,0,0,0,0,,0,0,0,0,0,0,0,0,Matches,96fcd380
1512,Robert Lewandowski,pl POL,FW,Bayern Munich,de Bundesliga,32,1988,32.7,10,3,0,6,4,5,17,29.4,12,17,2,15,6,16,8,0,Matches,8d78e732
1513,Jamie Leweling,de GER,FWMF,Greuther Fürth,de Bundesliga,20,2001,21.8,13,8,3,7,3,3,16,18.8,13,9,0,9,13,26,5,0,Matches,13fe7b69
1514,Jamal Lewis,nir NIR,DF,Newcastle Utd,eng Premier League,23,1998,2.9,8,6,6,1,1,3,4,75.0,1,3,2,1,3,11,8,0,Matches,efb9215a
1515,Luca Lezzerini,it ITA,GK,Venezia,it Serie A,26,1995,5.5,0,0,0,0,0,0,0,,0,1,0,1,0,0,0,0,Matches,c9c32262
1516,Ben Lhassine Kone,ci CIV,MF,Torino,it Serie A,21,2000,0.9,3,3,1,2,0,1,2,50.0,1,0,0,0,1,4,1,0,Matches,7452c7a8
1517,Yanis Lhery,fr FRA,MFFW,Saint-Étienne,fr Ligue 1,18,2003,0.8,0,0,0,0,0,0,0,,0,4,0,4,0,0,0,0,Matches,cc972842
1518,Dimitri Liénard,fr FRA,DFMF,Strasbourg,fr Ligue 1,33,1988,22.7,71,43,40,21,10,46,77,59.7,31,12,0,12,21,92,28,0,Matches,f7691f63
1519,Philipp Lienhart,at AUT,DF,Freiburg,de Bundesliga,25,1996,31.9,24,13,17,6,1,13,24,54.2,11,33,23,10,50,74,158,1,Matches,302527b2
1520,Matthijs de Ligt,nl NED,DF,Juventus,it Serie A,21,1999,29.7,34,19,21,13,0,15,18,83.3,3,31,21,10,26,60,103,0,Matches,d6e53a3a
1521,Isaac Lihadji,fr FRA,MF,Lille,fr Ligue 1,19,2002,2.6,3,3,1,1,1,1,5,20.0,4,1,0,1,2,5,0,0,Matches,57a46f3f
1522,Anderson Lima,br BRA,MF,Lazio,it Serie A,21,1999,0.7,2,0,1,1,0,0,2,0.0,2,1,0,1,2,4,1,0,Matches,59be3a74
1523,Andreas Linde,se SWE,GK,Greuther Fürth,de Bundesliga,28,1993,12.0,0,0,0,0,0,0,0,,0,0,0,0,1,1,1,1,Matches,4d6a842d
1524,Victor Lindelöf,se SWE,DF,Manchester Utd,eng Premier League,27,1994,26.2,16,11,9,7,0,9,14,64.3,5,26,17,9,25,41,96,0,Matches,f5deef4c
1525,Jesper Lindstrøm,dk DEN,MFFW,Eint Frankfurt,de Bundesliga,21,2000,22.0,28,13,6,13,9,12,36,33.3,24,30,0,30,24,52,11,1,Matches,37dc1a48
1526,Karol Linetty,pl POL,MFFW,Torino,it Serie A,26,1995,10.0,14,8,3,4,7,6,18,33.3,12,8,0,8,3,17,2,0,Matches,d023d70f
1527,Jesse Lingard,eng ENG,MFFW,Manchester Utd,eng Premier League,28,1992,4.1,9,7,4,3,2,2,6,33.3,4,4,0,4,0,9,1,0,Matches,810e3c74
1528,Pol Lirola,es ESP,DFMF,Marseille,fr Ligue 1,23,1997,19.7,28,16,15,9,4,13,28,46.4,15,15,0,15,13,41,22,0,Matches,ff800ed8
1529,Valentino Livramento,eng ENG,DF,Southampton,eng Premier League,18,2002,24.5,54,28,30,18,6,27,45,60.0,18,23,9,14,47,101,50,1,Matches,afed6722
1530,Dejan Ljubicic,at AUT,MF,Köln,de Bundesliga,23,1997,21.9,33,19,12,13,8,13,49,26.5,36,19,1,18,15,48,11,0,Matches,c455a2b2
1531,Javier Llabrés,,MF,Mallorca,es La Liga,,,1.5,2,1,0,1,1,1,2,50.0,1,1,0,1,0,2,0,0,Matches,38b0cf42
1532,Diego Llorente,es ESP,DF,Leeds United,eng Premier League,27,1993,26.0,53,31,32,19,2,33,47,70.2,14,35,17,18,40,93,77,2,Matches,bba30585
1533,Marcos Llorente,es ESP,MFDF,Atlético Madrid,es La Liga,26,1995,27.2,51,23,25,22,4,28,43,65.1,15,33,10,23,27,78,44,0,Matches,02c15616
1534,Hugo Lloris,fr FRA,GK,Tottenham,eng Premier League,34,1986,38.0,1,1,1,0,0,1,2,50.0,1,0,0,0,1,2,24,3,Matches,8f62b6ee
1535,Giovani Lo Celso,ar ARG,MFFW,Tottenham,eng Premier League,25,1996,2.6,8,4,4,2,2,4,10,40.0,6,6,1,5,1,9,0,1,Matches,d7553721
1536,Giovani Lo Celso,ar ARG,FWMF,Villarreal,es La Liga,25,1996,11.0,22,12,8,10,4,9,22,40.9,13,4,0,4,5,27,3,0,Matches,d7553721
1537,Julen Lobete,es ESP,FWMF,Real Sociedad,es La Liga,20,2000,3.2,4,3,3,0,1,1,2,50.0,1,6,1,5,1,5,1,0,Matches,a952a529
1538,Stanislav Lobotka,sk SVK,MF,Napoli,it Serie A,26,1994,18.7,39,24,16,20,3,14,36,38.9,22,9,1,8,12,51,13,1,Matches,e1cbb531
1539,Jürgen Locadia,nl NED,MFFW,Brighton,eng Premier League,27,1993,0.3,0,0,0,0,0,0,0,,0,0,0,0,0,0,0,0,Matches,6cc47ae1
1540,Jürgen Locadia,nl NED,FWMF,Bochum,de Bundesliga,27,1993,4.9,4,2,1,0,3,1,1,100.0,0,1,0,1,1,5,2,0,Matches,6cc47ae1
1541,Manuel Locatelli,it ITA,MF,Juventus,it Serie A,23,1998,24.0,44,25,21,16,7,21,47,44.7,26,43,21,22,22,66,33,0,Matches,a8a874f1
1542,Banzouzi Locko,fr FRA,MFDF,Reims,fr Ligue 1,19,2002,11.2,28,19,13,11,4,14,24,58.3,10,20,8,12,14,42,15,0,Matches,40221fa7
1543,Renan Lodi,br BRA,DF,Atlético Madrid,es La Liga,23,1998,13.1,31,18,14,13,4,11,27,40.7,16,22,4,18,13,44,19,1,Matches,ed9f7cfe
1544,Ruben Loftus-Cheek,eng ENG,MFDF,Chelsea,eng Premier League,25,1996,15.5,29,10,16,11,2,10,19,52.6,9,15,6,9,11,40,17,0,Matches,e97fd090
1545,Kevin Long,ie IRL,DF,Burnley,eng Premier League,30,1990,4.6,3,2,1,2,0,1,2,50.0,1,4,1,3,1,4,20,0,Matches,5a4280b1
1546,Shane Long,ie IRL,FW,Southampton,eng Premier League,34,1987,3.4,9,5,2,4,3,1,1,100.0,0,4,0,4,0,9,2,0,Matches,9f472354
1547,Sean Longstaff,eng ENG,MF,Newcastle Utd,eng Premier League,23,1997,16.3,54,34,18,31,5,24,65,36.9,41,18,6,12,9,63,18,0,Matches,a2b105e0
1548,Ademola Lookman,ng NGA,MFFW,Leicester City,eng Premier League,23,1997,16.1,32,14,10,13,9,10,28,35.7,18,19,1,18,10,42,4,0,Matches,7c104bb7
1549,Anthony Lopes,pt POR,GK,Lyon,fr Ligue 1,30,1990,33.1,0,0,0,0,0,0,0,,0,0,0,0,3,3,12,3,Matches,f00de885
1550,David López,es ESP,MFDF,Espanyol,es La Liga,31,1989,8.3,18,13,9,8,1,9,16,56.3,7,10,8,2,10,28,25,2,Matches,f03f284b
1551,Diego López,es ESP,GK,Espanyol,es La Liga,39,1981,35.3,0,0,0,0,0,0,2,0.0,2,0,0,0,1,1,21,1,Matches,73683fa9
1552,Javi López,es ESP,DF,Alavés,es La Liga,19,2002,5.1,8,6,6,2,0,4,6,66.7,2,7,1,6,4,12,15,0,Matches,e9ada8cf
1553,Maxime Lopez,fr FRA,MF,Sassuolo,it Serie A,23,1997,32.6,69,36,40,27,2,35,87,40.2,52,33,7,26,42,111,38,1,Matches,20094685
1554,Pau López,es ESP,GK,Marseille,fr Ligue 1,26,1994,29.0,0,0,0,0,0,0,1,0.0,1,0,0,0,0,0,12,1,Matches,20b9f052
1555,Unai López,es ESP,MF,Rayo Vallecano,es La Liga,25,1995,12.9,19,9,6,10,3,10,33,30.3,23,7,0,7,10,29,8,1,Matches,88050721
1556,Dion Lopy,sn SEN,MF,Reims,fr Ligue 1,19,2002,18.2,53,29,22,24,7,21,53,39.6,32,20,4,16,22,75,17,0,Matches,64c14d49
1557,Samuel Loric,fr FRA,DF,Lorient,fr Ligue 1,21,2000,3.0,7,5,2,3,2,5,8,62.5,3,2,0,2,5,12,9,0,Matches,9004f318
1558,Anthony Losilla,fr FRA,MF,Bochum,de Bundesliga,35,1986,32.6,67,39,29,32,6,35,70,50.0,35,33,9,24,70,137,54,1,Matches,07c7eb0c
1559,Jonas Lössl,dk DEN,GK,Brentford,eng Premier League,32,1989,2.0,0,0,0,0,0,0,0,,0,0,0,0,0,0,1,0,Matches,939bc634
1560,Marcel Lotka,pl POL,GK,Hertha BSC,de Bundesliga,20,2001,9.8,1,0,1,0,0,1,1,100.0,0,0,0,0,1,2,3,3,Matches,5584552e
1561,Jordan Lotomba,ch SUI,DF,Nice,fr Ligue 1,22,1998,19.8,33,17,21,9,3,16,30,53.3,14,17,4,13,12,45,28,0,Matches,fc4cf6a7
1562,Johaneko Louisjean,fr FRA,DF,Bordeaux,fr Ligue 1,17,2004,0.1,0,0,0,0,0,0,0,,0,0,0,0,0,0,0,0,Matches,9af3613f
1563,Imran Louza,ma MAR,MF,Watford,eng Premier League,22,1999,15.7,41,21,18,20,3,16,38,42.1,22,28,6,22,42,83,20,1,Matches,e1df6989
1564,Matteo Lovato,it ITA,DF,Atalanta,it Serie A,21,2000,3.4,5,4,4,1,0,0,1,0.0,1,4,2,2,7,12,8,0,Matches,5fa57166
1565,Matteo Lovato,it ITA,DF,Cagliari,it Serie A,21,2000,13.8,23,15,13,10,0,8,20,40.0,12,21,10,11,28,51,43,0,Matches,5fa57166
1566,Eduard Löwen,de GER,MF,Bochum,de Bundesliga,24,1997,15.7,33,22,12,13,8,11,45,24.4,34,17,2,15,9,42,15,1,Matches,70678132
1567,Matthew Lowton,eng ENG,DF,Burnley,eng Premier League,32,1989,19.7,38,24,20,10,8,20,37,54.1,17,25,11,14,26,64,68,0,Matches,9a9c05db
1568,Anthony Lozano,hn HON,FWMF,Cádiz,es La Liga,28,1993,18.6,8,4,2,3,3,5,18,27.8,13,16,2,14,2,10,7,0,Matches,38699c72
1569,Hirving Lozano,mx MEX,MFFW,Napoli,it Serie A,26,1995,17.9,28,20,12,11,5,8,30,26.7,22,24,0,24,9,37,9,0,Matches,a69e4806
1570,Jean Lucas,br BRA,MF,Monaco,fr Ligue 1,23,1998,16.1,43,25,14,24,5,17,40,42.5,23,15,5,10,13,56,4,1,Matches,a99138af
1571,Anderson Lucoqui,ao ANG,DF,Mainz 05,de Bundesliga,24,1997,8.3,22,10,11,6,5,11,22,50.0,11,15,3,12,11,33,10,0,Matches,5569bf9a
1572,Florentino Luís,pt POR,MF,Getafe,es La Liga,21,1999,11.0,42,25,22,17,3,17,35,48.6,18,21,2,19,21,63,11,1,Matches,881cd6be
1573,José Luis Gayà,es ESP,DF,Valencia,es La Liga,26,1995,20.8,35,21,24,10,1,16,34,47.1,18,17,3,14,19,54,37,0,Matches,b05e2dbd
1574,José Luis Morales,es ESP,FWMF,Levante,es La Liga,34,1987,30.2,27,17,6,9,12,12,42,28.6,30,29,0,29,4,31,7,0,Matches,4a478107
1575,José Luis Palomino,ar ARG,DF,Atalanta,it Serie A,31,1990,29.7,78,40,42,33,3,32,50,64.0,18,43,21,22,100,178,80,2,Matches,921f6058
1576,Luismi,es ESP,FWMF,Sevilla,es La Liga,20,2001,0.1,0,0,0,0,0,0,0,,0,0,0,0,0,0,0,0,Matches,acf5410c
1577,Douglas Luiz,br BRA,MF,Aston Villa,eng Premier League,23,1998,30.2,59,39,30,24,5,21,72,29.2,51,30,7,23,34,93,28,1,Matches,6f7d826d
1578,Romelu Lukaku,be BEL,FW,Chelsea,eng Premier League,28,1993,17.7,2,1,0,1,1,1,5,20.0,4,11,1,10,0,2,20,0,Matches,5eae500a
1579,Castello Lukeba,fr FRA,DF,Lyon,fr Ligue 1,18,2002,23.3,34,19,27,7,0,15,23,65.2,8,18,9,9,38,72,64,2,Matches,5b9512c5
1580,Dodi Lukebakio,be BEL,MFFW,Hertha BSC,de Bundesliga,23,1997,2.0,2,1,2,0,0,1,3,33.3,2,2,0,2,2,4,0,0,Matches,0c61c77c
1581,Dodi Lukebakio,be BEL,MF,Wolfsburg,de Bundesliga,23,1997,9.8,7,4,3,2,2,1,10,10.0,9,5,0,5,13,20,4,0,Matches,0c61c77c
1582,Saša Lukić,rs SRB,MF,Torino,it Serie A,24,1996,33.1,51,34,17,27,7,19,43,44.2,24,34,6,28,24,75,41,0,Matches,c6e8cf1f
1583,Levi Lumeka,eng ENG,MFFW,Troyes,fr Ligue 1,22,1998,0.7,0,0,0,0,0,0,2,0.0,2,0,0,0,0,0,2,0,Matches,199ff86e
1584,Andriy Lunin,ua UKR,GK,Real Madrid,es La Liga,22,1999,2.0,0,0,0,0,0,0,0,,0,0,0,0,0,0,2,0,Matches,3061e1ec
1585,Andrey Lunyov,ru RUS,GK,Leverkusen,de Bundesliga,29,1991,1.0,0,0,0,0,0,0,0,,0,0,0,0,0,0,0,0,Matches,8a6ab963
1586,Sebastiano Luperto,it ITA,DF,Empoli,it Serie A,24,1996,21.8,29,17,17,10,2,10,20,50.0,10,32,26,6,45,74,132,0,Matches,997fff07
1587,Andreas Luthe,de GER,GK,Union Berlin,de Bundesliga,34,1987,27.0,0,0,0,0,0,0,1,0.0,1,0,0,0,0,0,11,4,Matches,7fe12375
1588,Lyanco,br BRA,DF,Southampton,eng Premier League,24,1997,10.1,18,15,11,7,0,10,18,55.6,8,18,13,5,13,31,50,1,Matches,b5bf1770
1589,Charalambos Lykogiannis,gr GRE,DFFW,Cagliari,it Serie A,27,1993,20.2,19,12,16,1,2,11,20,55.0,9,18,8,10,31,50,73,0,Matches,5efc5389
1590,Yannis M'Bemba,fr FRA,DFFW,Nantes,fr Ligue 1,20,2001,0.1,0,0,0,0,0,0,0,,0,0,0,0,0,0,1,0,Matches,080de72a
1591,Alexis Mac Allister,ar ARG,MF,Brighton,eng Premier League,22,1998,23.6,65,40,23,30,12,29,68,42.6,39,37,7,30,13,78,22,0,Matches,83d074ff
1592,Deiver Machado,co COL,DFMF,Lens,fr Ligue 1,27,1993,5.8,16,14,11,1,4,12,14,85.7,2,9,1,8,3,19,12,1,Matches,b3f8bdef
1593,Darwin Machís,ve VEN,MFFW,Granada,es La Liga,28,1993,15.3,23,13,11,8,4,9,23,39.1,14,10,0,10,15,38,17,0,Matches,ed6ea4d9
1594,Yvann Macon,fr FRA,DF,Saint-Étienne,fr Ligue 1,22,1998,17.0,41,22,24,14,3,16,42,38.1,26,18,4,14,18,59,27,0,Matches,0bb6e193
1595,James Maddison,eng ENG,MFFW,Leicester City,eng Premier League,24,1996,27.3,40,20,8,24,8,14,46,30.4,32,18,3,15,11,51,12,0,Matches,ee38d9c5
1596,Niki Mäenpää,fi FIN,GK,Venezia,it Serie A,36,1985,16.5,0,0,0,0,0,0,0,,0,0,0,0,0,0,8,2,Matches,14a96e1c
1597,Pablo Maffeo,es ESP,DF,Mallorca,es La Liga,24,1997,32.7,84,47,48,28,8,38,69,55.1,31,30,13,17,46,130,74,0,Matches,5db04597
1598,Louis Mafouta,cf CTA,FW,Metz,fr Ligue 1,27,1994,5.8,0,0,0,0,0,0,5,0.0,5,1,0,1,0,0,4,0,Matches,bec3d251
1599,Giulio Maggiore,it ITA,MF,Spezia,it Serie A,23,1998,31.3,58,32,20,32,6,31,77,40.3,46,30,5,25,29,87,33,0,Matches,957e4c87
1600,Matej Maglica,hr CRO,MF,Stuttgart,de Bundesliga,22,1998,0.1,0,0,0,0,0,0,1,0.0,1,0,0,0,0,0,0,0,Matches,36cf2caf
1601,Francesco Magnanelli,it ITA,MF,Sassuolo,it Serie A,36,1984,3.0,5,4,4,1,0,1,9,11.1,8,3,1,2,1,6,3,0,Matches,07767f42
1602,Giangiacomo Magnani,it ITA,DF,Hellas Verona,it Serie A,25,1995,5.9,10,7,5,5,0,8,16,50.0,8,5,3,2,10,20,46,0,Matches,cce9f582
1603,Giangiacomo Magnani,it ITA,DF,Sampdoria,it Serie A,25,1995,2.7,4,2,4,0,0,1,1,100.0,0,2,2,0,7,11,12,0,Matches,cce9f582
1604,Hugo Magnetti,fr FRA,MF,Brest,fr Ligue 1,23,1998,16.3,50,34,27,20,3,22,50,44.0,28,13,3,10,25,75,13,0,Matches,d4d35152
1605,Yohann Magnin,fr FRA,MFDF,Clermont Foot,fr Ligue 1,24,1997,19.1,53,31,22,26,5,24,42,57.1,18,17,7,10,20,73,36,0,Matches,caa7aaea
1606,Harry Maguire,eng ENG,DF,Manchester Utd,eng Premier League,28,1993,27.9,34,21,22,8,4,19,31,61.3,12,36,29,7,32,66,101,3,Matches,d8931174
1607,Riyad Mahrez,dz ALG,FWMF,Manchester City,eng Premier League,30,1991,16.6,11,3,5,4,2,5,19,26.3,14,15,1,14,6,17,6,0,Matches,892d5bb1
1608,Arne Maier,de GER,MF,Augsburg,de Bundesliga,22,1999,20.7,20,13,6,10,4,8,26,30.8,18,18,1,17,15,35,13,0,Matches,ab700320
1609,Habib Maïga,ci CIV,MF,Metz,fr Ligue 1,25,1996,14.1,47,28,29,13,5,24,48,50.0,24,20,7,13,14,61,18,0,Matches,e768de1f
1610,Mike Maignan,fr FRA,GK,Milan,it Serie A,26,1995,32.0,2,1,2,0,0,2,2,100.0,0,0,0,0,1,3,4,2,Matches,fcb38f57
1611,Ainsley Maitland-Niles,eng ENG,MF,Arsenal,eng Premier League,23,1997,3.0,8,4,5,3,0,2,4,50.0,2,2,0,2,4,12,4,0,Matches,e3a5814e
1612,Ainsley Maitland-Niles,eng ENG,DF,Roma,it Serie A,23,1997,5.4,8,6,5,0,3,5,14,35.7,9,7,0,7,6,14,7,0,Matches,e3a5814e
1613,Josh Maja,ng NGA,FW,Bordeaux,fr Ligue 1,22,1998,0.1,0,0,0,0,0,0,0,,0,1,0,1,0,0,0,0,Matches,bc0bfc64
1614,Abdul Majeed Waris,gh GHA,FWMF,Strasbourg,fr Ligue 1,29,1991,3.6,5,3,2,3,0,5,10,50.0,5,2,0,2,0,5,1,0,Matches,46907171
1615,Lovro Majer,hr CRO,MFFW,Rennes,fr Ligue 1,23,1998,20.4,32,21,9,14,9,11,42,26.2,31,26,2,24,11,43,9,0,Matches,fc46aab1
1616,Jean-Victor Makengo,fr FRA,MF,Udinese,it Serie A,23,1998,26.1,30,21,7,17,6,15,29,51.7,14,26,6,20,19,49,17,0,Matches,22bfb57e
1617,Béni Makouana,cg CGO,FWMF,Montpellier,fr Ligue 1,18,2002,3.6,2,2,0,0,2,0,1,0.0,1,1,0,1,3,5,2,0,Matches,654f49ca
1618,Nemanja Maksimović,rs SRB,MF,Getafe,es La Liga,26,1995,32.6,56,32,24,26,6,18,49,36.7,31,42,13,29,71,127,41,0,Matches,00b28772
1619,Nikola Maksimović,rs SRB,DF,Genoa,it Serie A,29,1991,12.4,14,6,10,4,0,7,9,77.8,2,17,11,6,12,26,61,1,Matches,16b9d5cf
1620,Kévin Malcuit,ma MAR,DFMF,Napoli,it Serie A,30,1991,3.2,4,2,4,0,0,2,2,100.0,0,3,0,3,8,12,6,0,Matches,d6a889ea
1621,Daniel Maldini,it ITA,MF,Milan,it Serie A,19,2001,1.6,8,3,4,3,1,2,6,33.3,4,4,0,4,1,9,0,0,Matches,801831fe
1622,Youssef Maleh,it ITA,MF,Fiorentina,it Serie A,22,1998,11.3,27,16,8,13,6,12,25,48.0,13,14,1,13,6,33,2,0,Matches,4c8845f7
1623,Donyell Malen,nl NED,FWMF,Dortmund,de Bundesliga,22,1999,18.7,13,10,4,5,4,7,13,53.8,6,10,0,10,10,23,11,0,Matches,864163f3
1624,Ruslan Malinovskyi,ua UKR,MFFW,Atalanta,it Serie A,28,1993,17.7,18,10,3,10,5,5,19,26.3,14,27,3,24,5,23,1,0,Matches,48d5bd33
1625,Hugo Mallo,es ESP,DF,Celta Vigo,es La Liga,30,1991,20.3,45,25,24,19,2,16,31,51.6,15,23,9,14,20,65,53,0,Matches,cb574619
1626,Lennard Maloney,us USA,DF,Dortmund,de Bundesliga,21,1999,0.1,1,0,1,0,0,1,1,100.0,0,0,0,0,0,1,0,0,Matches,75402e99
1627,Mickael Malsa,mq MTQ,MF,Levante,es La Liga,25,1995,12.7,37,17,16,18,3,15,42,35.7,27,20,8,12,18,55,15,0,Matches,bbc19252
1628,Giorgi Mamardashvili,ge GEO,GK,Valencia,es La Liga,20,2000,18.0,0,0,0,0,0,0,0,,0,0,0,0,0,0,6,1,Matches,d4b73232
1629,Rey Manaj,al ALB,FW,Spezia,it Serie A,24,1997,19.6,19,12,3,11,5,6,26,23.1,20,16,0,16,4,23,13,0,Matches,7703afb6
1630,Hianga Mananga Mbock,fr FRA,MF,Brest,fr Ligue 1,21,1999,8.9,18,12,8,7,3,9,21,42.9,12,5,2,3,5,23,6,0,Matches,0f86995c
1631,Vincent Manceau,fr FRA,DF,Angers,fr Ligue 1,32,1989,26.2,32,19,18,13,1,14,37,37.8,23,23,6,17,32,64,72,0,Matches,c26a3918
1632,Gianluca Mancini,it ITA,DF,Roma,it Serie A,25,1996,32.0,41,25,22,18,1,18,33,54.5,15,38,19,19,39,80,69,0,Matches,5aa53281
1633,Leonardo Mancuso,it ITA,FW,Empoli,it Serie A,29,1992,4.7,1,1,0,1,0,0,6,0.0,6,2,0,2,1,2,2,0,Matches,311027cb
1634,Steve Mandanda,fr FRA,GK,Marseille,fr Ligue 1,36,1985,9.0,0,0,0,0,0,0,1,0.0,1,1,0,1,1,1,4,1,Matches,1d2d5cc8
1635,Reinildo Mandava,mz MOZ,DF,Atlético Madrid,es La Liga,27,1994,14.4,45,25,30,14,1,22,30,73.3,8,18,9,9,21,66,38,0,Matches,c20bdcd7
1636,Reinildo Mandava,mz MOZ,DF,Lille,fr Ligue 1,27,1994,16.9,43,23,29,11,3,32,51,62.7,19,13,4,9,37,80,55,0,Matches,c20bdcd7
1637,Aïssa Mandi,dz ALG,DF,Villarreal,es La Liga,29,1991,15.3,11,5,2,8,1,3,6,50.0,3,17,14,3,13,24,49,3,Matches,fbd6378b
1638,Rolando Mandragora,it ITA,MF,Torino,it Serie A,24,1997,14.7,21,10,3,16,2,12,21,57.1,9,18,4,14,10,31,13,0,Matches,c7259b83
1639,Anthony Mandrea,dz ALG,GK,Angers,fr Ligue 1,24,1996,10.0,0,0,0,0,0,0,0,,0,0,0,0,0,0,9,0,Matches,f7d3a773
1640,Sadio Mané,sn SEN,FW,Liverpool,eng Premier League,29,1992,31.3,33,20,7,14,12,8,26,30.8,18,30,1,29,8,41,15,0,Matches,c691bfe2
1641,Eliaquim Mangala,fr FRA,DF,Saint-Étienne,fr Ligue 1,30,1991,13.1,17,12,12,5,0,8,12,66.7,4,11,8,3,17,34,61,1,Matches,f520049f
1642,Orel Mangala,be BEL,MF,Stuttgart,de Bundesliga,23,1998,20.6,17,10,5,7,5,11,22,50.0,11,11,4,7,12,29,19,1,Matches,a572e291
1643,Thomas Mangani,fr FRA,MF,Angers,fr Ligue 1,34,1987,24.4,58,30,23,34,1,31,68,45.6,37,38,11,27,36,94,29,0,Matches,c801616a
1644,Ricardo Mangas,pt POR,DF,Bordeaux,fr Ligue 1,23,1998,26.1,35,22,22,8,5,26,41,63.4,15,18,4,14,25,60,47,3,Matches,eef2d8ce
1645,Kostas Manolas,gr GRE,DF,Napoli,it Serie A,30,1991,3.5,2,2,1,1,0,2,3,66.7,1,2,1,1,4,6,10,1,Matches,c707411f
1646,Javier Manquillo,es ESP,DF,Newcastle Utd,eng Premier League,27,1994,14.0,39,29,28,10,1,21,36,58.3,15,15,6,9,10,49,32,0,Matches,758dd7f0
1647,Myziane Maolida,fr FRA,MF,Nice,fr Ligue 1,22,1999,0.4,1,0,0,1,0,0,0,,0,1,0,1,0,1,0,0,Matches,706a60e1
1648,Myziane Maolida,fr FRA,MFFW,Hertha BSC,de Bundesliga,22,1999,8.6,7,4,5,1,1,3,9,33.3,6,5,0,5,1,8,6,0,Matches,706a60e1
1649,Sekou Mara,fr FRA,FWMF,Bordeaux,fr Ligue 1,19,2002,10.1,8,4,1,1,6,1,8,12.5,7,7,0,7,2,10,6,0,Matches,3544641e
1650,Maranhão,br BRA,FWMF,Valencia,es La Liga,24,1996,10.8,15,11,4,6,5,5,16,31.3,11,15,0,15,7,22,13,0,Matches,ae86d473
1651,Nikola Maraš,rs SRB,DF,Rayo Vallecano,es La Liga,25,1995,11.6,13,9,12,1,0,9,15,60.0,6,17,13,4,15,28,51,0,Matches,b9d0446f
1652,Fernando Marçal,br BRA,MFDF,Wolves,eng Premier League,32,1989,16.1,42,22,27,14,1,21,37,56.8,16,25,4,21,28,70,52,0,Matches,9ae9eaea
1653,Marcelo,br BRA,DF,Real Madrid,es La Liga,33,1988,5.8,8,4,2,3,3,5,10,50.0,5,7,2,5,1,9,11,0,Matches,603116a7
1654,Marcelo,br BRA,DF,Bordeaux,fr Ligue 1,34,1987,10.0,9,5,7,2,0,4,6,66.7,2,4,3,1,13,22,46,1,Matches,e3d0b0c4
1655,Marcelo,br BRA,DF,Lyon,fr Ligue 1,34,1987,2.0,4,3,0,4,0,4,6,66.7,2,3,2,1,4,8,10,0,Matches,e3d0b0c4
1656,Solly March,eng ENG,DFMF,Brighton,eng Premier League,27,1994,19.4,30,17,11,9,10,7,22,31.8,15,22,3,19,17,47,25,0,Matches,bb5fbd2b
1657,Riccardo Marchizza,it ITA,DF,Empoli,it Serie A,23,1998,15.0,21,15,11,8,2,11,16,68.8,5,15,6,9,10,31,24,0,Matches,91d0fabf
1658,Gian Marco Ferrari,it ITA,DF,Sassuolo,it Serie A,29,1992,34.7,16,11,10,6,0,10,23,43.5,13,37,27,10,43,59,114,2,Matches,8650af85
1659,Iván Marcone,ar ARG,MF,Elche,es La Liga,31,1990,9.0,24,14,17,6,1,12,24,50.0,12,8,3,5,12,36,13,0,Matches,b14f755d
1660,Óscar de Marcos,es ESP,DF,Athletic Club,es La Liga,32,1989,18.7,50,37,24,19,7,28,43,65.1,15,20,3,17,19,69,27,0,Matches,9f323c71
1661,Davide Marfella,it ITA,GK,Napoli,it Serie A,21,1999,0.1,0,0,0,0,0,0,0,,0,0,0,0,0,0,0,0,Matches,880fcdbb
1662,José Mari,es ESP,MF,Cádiz,es La Liga,33,1987,4.3,14,7,3,10,1,7,8,87.5,1,4,1,3,7,21,2,0,Matches,6f4c734d
1663,Pablo Marí,es ESP,DF,Arsenal,eng Premier League,27,1993,2.0,5,3,1,3,1,3,6,50.0,3,5,4,1,3,8,10,0,Matches,aa54ec6f
1664,Pablo Marí,es ESP,DF,Udinese,it Serie A,27,1993,14.9,16,8,8,6,2,8,16,50.0,8,18,12,6,21,37,72,0,Matches,aa54ec6f
1665,José María Giménez,uy URU,DF,Atlético Madrid,es La Liga,26,1995,22.7,18,12,12,6,0,8,16,50.0,8,25,19,6,25,43,96,1,Matches,f0da930c
1666,Mariano,do DOM,FW,Real Madrid,es La Liga,27,1993,3.8,2,0,2,0,0,0,0,,0,2,0,2,1,3,3,0,Matches,5c4dc0ff
1667,Răzvan Marin,ro ROU,MF,Cagliari,it Serie A,25,1996,31.3,42,21,16,22,4,24,54,44.4,30,23,5,18,10,52,17,1,Matches,7fac99d4
1668,Guillermo Maripán,cl CHI,DF,Monaco,fr Ligue 1,27,1994,20.4,36,24,27,9,0,20,40,50.0,20,21,14,7,25,61,66,1,Matches,d9764034
1669,Mika Màrmol,es ESP,DF,Barcelona,es La Liga,20,2001,0.0,0,0,0,0,0,0,0,,0,0,0,0,0,0,0,0,Matches,e7630876
1670,Omar Marmoush,eg EGY,MF,Wolfsburg,de Bundesliga,22,1999,0.3,0,0,0,0,0,0,0,,0,0,0,0,0,0,0,0,Matches,0e0102eb
1671,Omar Marmoush,eg EGY,FW,Stuttgart,de Bundesliga,22,1999,17.5,26,17,6,14,6,4,20,20.0,16,9,1,8,7,33,6,0,Matches,0e0102eb
1672,Marquinhos,br BRA,DF,Paris S-G,fr Ligue 1,27,1994,31.8,37,14,25,11,1,20,35,57.1,15,35,19,16,16,53,102,0,Matches,d5f2f82b
1673,Roger Martí,es ESP,FW,Levante,es La Liga,30,1991,23.5,23,14,3,13,7,8,30,26.7,22,14,0,14,2,25,8,0,Matches,0ae4e09a
1674,Anthony Martial,fr FRA,FWMF,Manchester Utd,eng Premier League,25,1995,2.4,0,0,0,0,0,0,1,0.0,1,1,0,1,0,0,1,0,Matches,8b788c01
1675,Anthony Martial,fr FRA,FWMF,Sevilla,es La Liga,25,1995,5.4,2,1,0,0,2,2,6,33.3,4,4,0,4,0,2,3,0,Matches,8b788c01
1676,Martín,es ESP,MF,Cádiz,es La Liga,22,1999,1.3,2,2,0,2,0,0,0,,0,1,0,1,1,3,3,0,Matches,cbec0059
1677,Aarón Martín,es ESP,DF,Mainz 05,de Bundesliga,24,1997,25.5,54,33,32,18,4,24,55,43.6,31,24,4,20,20,74,35,0,Matches,2f3e911a
1678,Ander Martin,es ESP,MF,Real Sociedad,es La Liga,20,2000,1.0,1,0,0,1,0,1,1,100.0,0,0,0,0,3,4,1,0,Matches,e1e75690
1679,Andrés Martín,es ESP,MFFW,Rayo Vallecano,es La Liga,22,1999,2.1,0,0,0,0,0,0,1,0.0,1,1,0,1,0,0,0,0,Matches,2ae30661
1680,Carlos Martín,es ESP,DF,Atlético Madrid,es La Liga,19,2002,0.1,0,0,0,0,0,0,0,,0,0,0,0,0,0,1,0,Matches,64035864
1681,Iván Martín,es ESP,MF,Alavés,es La Liga,22,1999,1.8,1,1,1,0,0,0,1,0.0,1,2,0,2,1,2,1,0,Matches,ae48c5cb
1682,Jonas Martin,fr FRA,MF,Rennes,fr Ligue 1,31,1990,23.4,35,20,12,21,2,19,53,35.8,34,17,3,14,22,57,28,1,Matches,468fdbad
1683,Martinelli,br BRA,MFFW,Arsenal,eng Premier League,20,2001,20.7,27,19,7,14,6,10,29,34.5,19,26,1,25,20,47,15,0,Matches,48a5a5d6
1684,Emiliano Martínez,ar ARG,GK,Aston Villa,eng Premier League,28,1992,36.0,1,1,1,0,0,1,3,33.3,2,0,0,0,0,1,6,1,Matches,7956236f
1685,Iñigo Martínez,es ESP,DF,Athletic Club,es La Liga,30,1991,26.0,28,13,18,7,3,14,23,60.9,9,22,10,12,39,67,143,0,Matches,3fc45c73
1686,Javi Martínez,es ESP,MFFW,Osasuna,es La Liga,21,1999,9.8,21,14,8,11,2,10,29,34.5,19,6,0,6,9,30,10,0,Matches,3672b352
1687,Josep Martinez,es ESP,GK,RB Leipzig,de Bundesliga,23,1998,1.0,0,0,0,0,0,0,0,,0,0,0,0,0,0,0,0,Matches,11d8aff0
1688,Lautaro Martínez,ar ARG,FW,Inter,it Serie A,23,1997,25.4,20,10,3,10,7,6,11,54.5,5,21,1,20,18,38,6,0,Matches,f7036e1c
1689,Pablo Martínez,es ESP,MF,Levante,es La Liga,23,1998,7.3,15,8,7,8,0,4,13,30.8,9,6,3,3,15,30,5,0,Matches,ecc77652
1690,Lucas Martínez Quarta,ar ARG,DF,Fiorentina,it Serie A,25,1996,15.9,36,25,23,11,2,21,34,61.8,13,22,9,13,19,55,46,0,Matches,3ec3c1c9
1691,Gelson Martins,pt POR,MF,Monaco,fr Ligue 1,26,1995,21.2,42,27,10,26,6,21,59,35.6,38,26,1,25,17,59,4,0,Matches,3ef0fa48
1692,Adam Marušić,me MNE,DF,Lazio,it Serie A,28,1992,30.2,30,18,16,12,2,13,32,40.6,19,19,8,11,41,71,71,0,Matches,d4535821
1693,Omar Mascarell,es ESP,MF,Elche,es La Liga,28,1993,27.7,46,26,16,23,7,24,60,40.0,36,42,14,28,48,94,52,2,Matches,11fd2b75
1694,Andrea Masiello,it ITA,DF,Genoa,it Serie A,35,1986,5.7,5,3,4,1,0,4,7,57.1,3,8,4,4,11,16,20,1,Matches,e0314d87
1695,Adam Masina,ma MAR,DF,Watford,eng Premier League,27,1994,12.0,24,13,11,10,3,12,29,41.4,17,18,6,12,18,42,45,0,Matches,de0f152c
1696,Erhan Mašović,rs SRB,DF,Bochum,de Bundesliga,22,1998,17.2,37,20,22,14,1,22,35,62.9,13,31,20,11,34,71,65,1,Matches,a396fb61
1697,Roberto Massimo,de GER,DFFW,Stuttgart,de Bundesliga,20,2000,9.7,14,5,6,7,1,4,16,25.0,12,9,0,9,3,17,6,0,Matches,fc62fdf4
1698,Arthur Masuaku,cd COD,DFMF,West Ham,eng Premier League,27,1993,7.2,31,23,19,11,1,14,23,60.9,9,9,1,8,9,40,17,0,Matches,57df7a11
1699,Jaime Mata,es ESP,FW,Getafe,es La Liga,32,1988,7.5,7,5,3,1,3,1,9,11.1,8,4,1,3,1,8,5,0,Matches,02319ad7
1700,Juan Mata,es ESP,MF,Manchester Utd,eng Premier League,33,1988,2.6,6,4,2,3,1,3,5,60.0,2,1,0,1,1,7,1,0,Matches,29733c72
1701,Pape Matar Sarr,sn SEN,MF,Metz,fr Ligue 1,18,2002,23.7,45,26,21,23,1,18,39,46.2,21,33,3,30,29,74,22,0,Matches,feb5d972
1702,Eliot Matazo,be BEL,MF,Monaco,fr Ligue 1,19,2002,8.8,8,7,4,4,0,2,11,18.2,9,11,3,8,13,21,9,0,Matches,15944afd
1703,Aleš Matějů,cz CZE,DF,Venezia,it Serie A,25,1996,8.1,16,12,10,5,1,13,29,44.8,16,10,6,4,9,25,15,0,Matches,deb748c9
1704,Jean-Philippe Mateta,fr FRA,FW,Crystal Palace,eng Premier League,24,1997,12.7,8,4,2,5,1,3,18,16.7,15,11,3,8,4,12,13,0,Matches,50e6dc35
1705,Nemanja Matić,rs SRB,MF,Manchester Utd,eng Premier League,32,1988,15.4,31,18,19,11,1,15,31,48.4,16,21,6,15,31,62,21,3,Matches,eb7822d7
1706,Joël Matip,cm CMR,DF,Liverpool,eng Premier League,29,1991,31.0,47,34,23,19,5,20,31,64.5,11,26,14,12,44,91,93,1,Matches,b217ef29
1707,Chrislain Matsima,fr FRA,DF,Monaco,fr Ligue 1,19,2002,1.5,3,2,1,2,0,2,7,28.6,5,3,3,0,1,4,6,1,Matches,cf1ef7ec
1708,Azor Matusiwa,nl NED,MF,Reims,fr Ligue 1,23,1998,27.4,58,32,28,26,4,26,55,47.3,29,49,19,30,62,120,43,0,Matches,a17a94d6
1709,Neal Maupay,fr FRA,FW,Brighton,eng Premier League,24,1996,25.3,17,10,2,6,9,4,18,22.2,14,21,2,19,2,19,2,0,Matches,4bcf39f6
1710,Stephy Mavididi,eng ENG,MFFW,Montpellier,fr Ligue 1,23,1998,25.5,24,13,11,7,6,14,39,35.9,25,23,2,21,8,32,11,0,Matches,30144daa
1711,Konstantinos Mavropanos,gr GRE,DF,Stuttgart,de Bundesliga,23,1997,30.1,57,39,35,21,1,30,51,58.8,21,46,23,23,69,126,174,2,Matches,00963611
1712,Eric Maxim Choupo-Moting,cm CMR,MFFW,Bayern Munich,de Bundesliga,32,1989,4.2,10,9,3,6,1,3,10,30.0,7,1,0,1,5,15,2,0,Matches,0e6bc38c
1713,Luís Maximiano,pt POR,GK,Granada,es La Liga,22,1999,34.8,3,1,3,0,0,3,6,50.0,3,0,0,0,1,4,16,2,Matches,3318286e
1714,Borja Mayoral,es ESP,FWDF,Roma,it Serie A,24,1997,1.1,0,0,0,0,0,0,0,,0,0,0,0,0,0,0,0,Matches,64e8ed6d
1715,Borja Mayoral,es ESP,FW,Getafe,es La Liga,24,1997,11.6,7,5,2,3,2,1,2,50.0,1,10,4,6,4,11,3,0,Matches,64e8ed6d
1716,Derek Mazou-Sacko,fr FRA,FWDF,Troyes,fr Ligue 1,16,2004,0.0,1,0,0,0,1,1,1,100.0,0,0,0,0,0,1,1,0,Matches,810edef9
1717,Pasquale Mazzocchi,it ITA,DF,Venezia,it Serie A,26,1995,13.8,18,8,11,4,3,10,26,38.5,16,11,8,3,21,39,31,1,Matches,eb0ec070
1718,Pasquale Mazzocchi,it ITA,DF,Salernitana,it Serie A,26,1995,14.1,28,19,15,11,2,14,34,41.2,20,5,0,5,11,39,31,0,Matches,eb0ec070
1719,Kevin Mbabu,ch SUI,DF,Wolfsburg,de Bundesliga,26,1995,15.5,31,20,21,5,5,12,23,52.2,11,25,8,17,35,66,35,0,Matches,493924a7
1720,Kylian Mbappé,fr FRA,FW,Paris S-G,fr Ligue 1,22,1998,33.6,11,8,1,4,6,7,13,53.8,6,6,0,6,5,16,13,0,Matches,42fd9c7f
1721,Ibrahima Mbaye,sn SEN,DF,Bologna,it Serie A,26,1994,1.2,1,1,1,0,0,1,2,50.0,1,1,1,0,1,2,6,0,Matches,cfbf9881
1722,Amadou Mbengue,sn SEN,DFMF,Metz,fr Ligue 1,19,2002,6.8,19,10,10,9,0,11,22,50.0,11,7,2,5,10,29,19,0,Matches,14d2670e
1723,Bryan Mbeumo,cm CMR,FW,Brentford,eng Premier League,21,1999,32.3,28,16,1,12,15,6,20,30.0,14,21,6,15,11,39,20,0,Matches,6afaebf2
1724,Jason Mbock,fr FRA,FW,Angers,fr Ligue 1,21,1999,0.2,0,0,0,0,0,0,0,,0,0,0,0,0,0,0,0,Matches,890bc029
1725,Jordi Mboula,es ESP,MFFW,Mallorca,es La Liga,22,1999,4.8,8,2,3,3,2,5,9,55.6,4,7,1,6,3,11,3,0,Matches,4887118d
1726,Moustapha Mbow,sn SEN,DF,Reims,fr Ligue 1,21,2000,1.0,6,6,3,2,1,3,3,100.0,0,0,0,0,1,7,6,0,Matches,3f3a2cba
1727,Nathanael Mbuku,fr FRA,FWMF,Reims,fr Ligue 1,19,2002,15.8,14,13,4,7,3,2,8,25.0,6,14,0,14,11,25,4,0,Matches,46750e9c
1728,James McArthur,sct SCO,MF,Crystal Palace,eng Premier League,33,1987,16.0,33,23,13,19,1,16,44,36.4,28,23,9,14,30,63,27,0,Matches,cee31595
1729,James Mcatee,eng ENG,MFFW,Manchester City,eng Premier League,18,2002,0.2,0,0,0,0,0,0,2,0.0,2,0,0,0,0,0,0,0,Matches,96593e89
1730,Kasey McAteer,eng ENG,MF,Leicester City,eng Premier League,19,2001,0.0,0,0,0,0,0,0,0,,0,0,0,0,0,0,0,0,Matches,b2c66859
1731,Liam McCarron,sct SCO,MF,Leeds United,eng Premier League,20,2001,0.1,0,0,0,0,0,0,0,,0,1,0,1,0,0,0,0,Matches,076bb352
1732,Alex McCarthy,eng ENG,GK,Southampton,eng Premier League,31,1989,17.0,0,0,0,0,0,0,0,,0,0,0,0,0,0,4,0,Matches,36c2ca73
1733,John McGinn,sct SCO,MF,Aston Villa,eng Premier League,26,1994,34.3,106,64,35,55,16,54,104,51.9,50,53,6,47,35,141,34,0,Matches,90f91999
1734,Weston McKennie,us USA,MF,Juventus,it Serie A,22,1998,15.2,20,11,11,7,2,8,26,30.8,18,17,8,9,23,43,20,0,Matches,01c3aff5
1735,Stuart McKinstry,sct SCO,MF,Leeds United,eng Premier League,18,2002,0.0,0,0,0,0,0,0,0,,0,0,0,0,0,0,0,0,Matches,1000a059
1736,Kenny McLean,sct SCO,MF,Norwich City,eng Premier League,29,1992,30.1,42,22,18,20,4,17,59,28.8,42,29,7,22,34,76,54,0,Matches,471f16b3
1737,Dwight McNeil,eng ENG,MF,Burnley,eng Premier League,21,1999,34.5,78,49,27,38,13,33,73,45.2,40,64,11,53,35,113,31,1,Matches,fc15fb84
1738,Scott McTominay,sct SCO,MF,Manchester Utd,eng Premier League,24,1996,26.5,65,33,32,24,9,30,61,49.2,31,45,10,35,31,96,60,1,Matches,d93c2511
1739,Gary Medel,cl CHI,DF,Bologna,it Serie A,33,1987,31.4,39,23,27,11,1,16,36,44.4,20,30,21,9,44,83,112,0,Matches,563a68ad
1740,Facundo Medina,ar ARG,DF,Lens,fr Ligue 1,22,1999,28.8,61,42,34,23,4,38,62,61.3,24,24,8,16,37,98,78,3,Matches,6f5ec8bb
1741,Nathan de Medina,be BEL,DF,Arminia,de Bundesliga,23,1997,8.6,17,10,11,6,0,6,10,60.0,4,14,3,11,10,27,28,0,Matches,d686dbc0
1742,Ben Mee,eng ENG,DF,Burnley,eng Premier League,31,1989,20.4,26,12,16,7,3,12,19,63.2,7,28,22,6,24,50,94,1,Matches,8df7a2fb
1743,Admir Mehmedi,ch SUI,DF,Wolfsburg,de Bundesliga,30,1991,0.0,0,0,0,0,0,0,0,,0,0,0,0,0,0,0,0,Matches,b500b384
1744,Hannibal Mejbri,tn TUN,MFFW,Manchester Utd,eng Premier League,18,2003,0.8,2,1,1,1,0,1,1,100.0,0,0,0,0,0,2,0,0,Matches,ca22ccb0
1745,Farid El Melali,dz ALG,FW,Angers,fr Ligue 1,24,1997,0.2,0,0,0,0,0,0,1,0.0,1,1,0,1,0,0,1,0,Matches,d21e361a
1746,Filippo Melegoni,it ITA,MF,Genoa,it Serie A,22,1999,10.9,20,12,5,8,7,8,16,50.0,8,10,1,9,11,31,8,1,Matches,6604165d
1747,Óscar Melendo,es ESP,MFFW,Espanyol,es La Liga,23,1997,11.0,11,5,4,4,3,3,13,23.1,10,4,1,3,1,12,10,0,Matches,379652be
1748,Gonzalo Melero,es ESP,MF,Levante,es La Liga,27,1994,18.8,29,16,10,15,4,16,36,44.4,20,21,8,13,7,36,22,0,Matches,3902e91b
1749,Birger Meling,no NOR,DF,Rennes,fr Ligue 1,26,1994,20.3,43,27,25,11,7,23,31,74.2,8,23,7,16,22,65,40,0,Matches,70c52749
1750,Arthur Melo,br BRA,MF,Juventus,it Serie A,24,1996,10.7,25,12,10,14,1,13,24,54.2,11,11,2,9,7,32,8,1,Matches,48b3dd60
1751,Houboulang Mendes,fr FRA,DF,Lorient,fr Ligue 1,23,1998,35.8,58,28,37,18,3,40,57,70.2,17,41,21,20,41,99,128,4,Matches,1545cf15
1752,Nuno Mendes,pt POR,DF,Paris S-G,fr Ligue 1,19,2002,18.4,48,29,23,18,7,25,47,53.2,22,27,5,22,21,69,17,1,Matches,f20e4cc9
1753,Pedro Mendes,pt POR,DF,Montpellier,fr Ligue 1,30,1990,0.2,1,1,1,0,0,0,0,,0,1,1,0,0,1,2,0,Matches,6690ef25
1754,Thiago Mendes,br BRA,MFDF,Lyon,fr Ligue 1,29,1992,20.7,36,22,18,16,2,12,30,40.0,18,24,5,19,34,70,56,1,Matches,c6e5d20f
1755,Tomás Mendes,es ESP,MF,Alavés,es La Liga,16,2004,0.1,0,0,0,0,0,0,0,,0,0,0,0,0,0,1,0,Matches,45f771db
1756,Brais Méndez,es ESP,MF,Celta Vigo,es La Liga,24,1997,33.6,68,35,24,35,9,26,87,29.9,61,52,6,46,37,105,30,0,Matches,c9e39d91
1757,Édgar Méndez,es ESP,MFFW,Alavés,es La Liga,31,1990,17.9,25,14,11,10,4,11,34,32.4,23,16,0,16,4,29,17,0,Matches,aed746df
1758,Arial Mendy,sn SEN,DFMF,Clermont Foot,fr Ligue 1,26,1994,8.8,6,4,4,2,0,2,11,18.2,9,6,1,5,7,13,17,0,Matches,9f0f4b49
1759,Batista Mendy,fr FRA,MFDF,Angers,fr Ligue 1,21,2000,26.8,49,28,21,22,6,23,45,51.1,22,37,6,31,34,83,40,0,Matches,e472a6f6
1760,Benjamin Mendy,fr FRA,DF,Manchester City,eng Premier League,27,1994,0.9,2,2,1,1,0,2,6,33.3,4,0,0,0,0,2,0,0,Matches,5271c8f1
1761,Edouard Mendy,sn SEN,GK,Chelsea,eng Premier League,29,1992,34.0,1,0,1,0,0,1,3,33.3,2,0,0,0,0,1,13,4,Matches,33887998
1762,Ferland Mendy,fr FRA,DF,Real Madrid,es La Liga,26,1995,19.3,24,14,11,10,3,8,14,57.1,6,8,2,6,18,42,27,3,Matches,3cefcaef
1763,Nampalys Mendy,sn SEN,MF,Leicester City,eng Premier League,29,1992,11.5,12,6,8,4,0,6,17,35.3,11,7,4,3,11,23,11,1,Matches,1598599e
1764,Gideon Mensah,gh GHA,DF,Bordeaux,fr Ligue 1,23,1998,13.4,37,24,19,12,6,18,38,47.4,20,11,2,9,16,53,21,0,Matches,9bdd8118
1765,Jorge Meré,es ESP,DF,Köln,de Bundesliga,24,1997,5.4,9,6,3,6,0,4,7,57.1,3,6,4,2,10,19,19,0,Matches,9f979eb2
1766,Alex Meret,it ITA,GK,Napoli,it Serie A,24,1997,6.9,0,0,0,0,0,0,0,,0,0,0,0,0,0,3,1,Matches,9413b19f
1767,Fran Mérida,es ESP,MF,Espanyol,es La Liga,31,1990,3.0,7,3,5,2,0,4,10,40.0,6,1,0,1,6,13,1,0,Matches,0e50f929
1768,Mikel Merino,es ESP,MF,Real Sociedad,es La Liga,25,1996,32.1,71,38,21,40,10,26,67,38.8,41,50,10,40,21,92,56,2,Matches,d080ed5e
1769,Quentin Merlin,fr FRA,DFMF,Nantes,fr Ligue 1,19,2002,21.4,45,28,19,20,6,26,49,53.1,23,25,4,21,27,72,29,2,Matches,0bfca6a1
1770,Martín Merquelanz,es ESP,MF,Rayo Vallecano,es La Liga,26,1995,1.9,2,1,2,0,0,2,6,33.3,4,2,0,2,0,2,1,0,Matches,ddd5348b
1771,Yıldırım Mert Çetin,tr TUR,MF,Hellas Verona,it Serie A,24,1997,0.5,1,0,1,0,0,1,1,100.0,0,0,0,0,0,1,2,0,Matches,c730da00
1772,Dries Mertens,be BEL,FWMF,Napoli,it Serie A,34,1987,15.4,16,7,1,11,4,3,16,18.8,13,8,2,6,9,25,2,0,Matches,89b2c8a9
1773,Illan Meslier,fr FRA,GK,Leeds United,eng Premier League,21,2000,37.6,1,1,1,0,0,1,1,100.0,0,0,0,0,0,1,27,1,Matches,6b625ac2
1774,Lionel Messi,ar ARG,FWMF,Paris S-G,fr Ligue 1,34,1987,23.9,10,3,1,5,4,3,13,23.1,10,5,0,5,4,14,0,0,Matches,d70ce98e
1775,Junior Messias,br BRA,MF,Milan,it Serie A,30,1991,15.9,34,18,11,14,9,15,34,44.1,19,11,1,10,17,51,17,0,Matches,f49c4ae9
1776,Thomas Meunier,be BEL,DF,Dortmund,de Bundesliga,29,1991,15.6,29,19,13,12,4,16,33,48.5,17,10,2,8,12,41,25,1,Matches,e162b013
1777,Mexer,mz MOZ,DF,Bordeaux,fr Ligue 1,32,1988,13.6,14,10,11,3,0,11,17,64.7,6,12,7,5,21,35,60,2,Matches,ce492295
1778,Marco Meyerhöfer,de GER,DF,Greuther Fürth,de Bundesliga,25,1995,25.3,53,35,22,22,9,24,37,64.9,13,38,19,19,47,100,64,1,Matches,0b104510
1779,Matt Miazga,us USA,DF,Alavés,es La Liga,26,1995,9.3,7,7,3,4,0,2,7,28.6,5,14,12,2,11,18,55,1,Matches,9fc0f253
1780,Kingsley Michael,ng NGA,MF,Bologna,it Serie A,21,1999,0.8,4,1,2,2,0,1,2,50.0,1,2,1,1,1,5,1,1,Matches,e63e122d
1781,Sven Michel,de GER,FW,Union Berlin,de Bundesliga,31,1990,3.8,10,6,5,3,2,2,8,25.0,6,3,0,3,1,11,1,0,Matches,1e274a0a
1782,Edouard Michut,fr FRA,MF,Paris S-G,fr Ligue 1,18,2003,0.8,0,0,0,0,0,0,2,0.0,2,2,0,2,1,1,2,0,Matches,fe6c1add
1783,Miguel,es ESP,FWMF,Alavés,es La Liga,21,1999,9.2,7,3,1,5,1,2,15,13.3,13,6,0,6,1,8,7,0,Matches,6763373d
1784,Valentin Mihaila,ro ROU,MFFW,Atalanta,it Serie A,21,2000,0.8,1,1,0,1,0,0,1,0.0,1,2,0,2,0,1,0,0,Matches,81a4c239
1785,Mikael,br BRA,FWMF,Salernitana,it Serie A,22,1999,1.0,1,1,0,1,0,0,0,,0,0,0,0,0,1,1,0,Matches,33502726
1786,Hilmir Mikaelsson,is ISL,FW,Venezia,it Serie A,17,2004,0.2,2,0,0,1,1,0,0,,0,0,0,0,0,2,0,0,Matches,5add9b29
1787,Georges Mikautadze,ge GEO,FW,Metz,fr Ligue 1,20,2000,0.0,0,0,0,0,0,0,0,,0,0,0,0,0,0,0,0,Matches,4788cb6b
1788,William Mikelbrencis,fr FRA,DF,Metz,fr Ligue 1,17,2004,6.8,11,5,6,4,1,6,9,66.7,3,6,3,3,5,16,9,0,Matches,14df1d7f
1789,Nikola Milenković,rs SRB,DF,Fiorentina,it Serie A,23,1997,32.5,54,32,31,20,3,29,34,85.3,5,30,15,15,39,93,94,0,Matches,bee704fc
1790,Arkadiusz Milik,pl POL,FW,Marseille,fr Ligue 1,27,1994,15.7,9,2,0,5,4,4,18,22.2,14,9,1,8,3,12,10,1,Matches,85613cf0
1791,Sergej Milinković-Savić,rs SRB,MF,Lazio,it Serie A,26,1995,34.4,67,44,20,32,15,29,67,43.3,38,50,9,41,34,101,43,1,Matches,4e6dbac4
1792,Vanja Milinković-Savić,rs SRB,GK,Torino,it Serie A,24,1997,27.0,0,0,0,0,0,0,1,0.0,1,0,0,0,0,0,7,2,Matches,9fa26bc2
1793,Éder Militão,br BRA,DF,Real Madrid,es La Liga,23,1998,33.7,50,32,30,12,8,20,39,51.3,19,42,20,22,52,102,107,3,Matches,2784f898
1794,Luka Milivojević,rs SRB,MF,Crystal Palace,eng Premier League,30,1991,8.6,18,9,9,6,3,10,16,62.5,6,6,1,5,11,29,15,0,Matches,2ce2508a
1795,Luis Milla,es ESP,MF,Granada,es La Liga,26,1994,30.8,59,29,25,30,4,25,64,39.1,39,28,4,24,25,84,34,0,Matches,19c36442
1796,Pere Milla,es ESP,MFFW,Elche,es La Liga,28,1992,18.3,20,15,14,5,1,8,44,18.2,36,21,1,20,5,25,21,0,Matches,335039a2
1797,Enzo Millot,fr FRA,MF,Stuttgart,de Bundesliga,19,2002,0.6,2,0,0,2,0,0,1,0.0,1,0,0,0,1,3,1,0,Matches,f76022e7
1798,James Milner,eng ENG,MFDF,Liverpool,eng Premier League,35,1986,9.5,28,16,12,11,5,12,29,41.4,17,19,5,14,17,45,20,0,Matches,2f90f6b8
1799,Santi Mina,es ESP,FW,Celta Vigo,es La Liga,25,1995,26.3,27,17,8,15,4,5,32,15.6,27,28,2,26,6,33,22,0,Matches,0b90bb97
1800,Yerry Mina,co COL,DF,Everton,eng Premier League,26,1994,9.4,12,10,12,0,0,10,13,76.9,3,13,9,4,11,23,38,1,Matches,6d5701f2
1801,Takumi Minamino,jp JPN,FWMF,Liverpool,eng Premier League,26,1995,2.1,3,2,1,1,1,2,8,25.0,6,2,0,2,1,4,2,0,Matches,f833a830
1802,Tyrone Mings,eng ENG,DF,Aston Villa,eng Premier League,28,1993,35.4,23,12,17,3,3,14,22,63.6,8,47,30,17,46,69,153,2,Matches,8397a50c
1803,Óscar Mingueza,es ESP,DF,Barcelona,es La Liga,22,1999,9.9,25,11,12,11,2,16,23,69.6,7,5,0,5,9,34,22,1,Matches,056269d7
1804,Rafa Mir,es ESP,FW,Sevilla,es La Liga,24,1997,20.1,4,3,1,1,2,0,11,0.0,11,4,3,1,0,4,17,0,Matches,bbf5c11b
1805,Jorge Miramón,es ESP,DF,Levante,es La Liga,32,1989,22.0,36,19,16,12,8,15,44,34.1,29,15,3,12,35,71,58,0,Matches,7f4c7c9f
1806,Aleksei Miranchuk,ru RUS,MFFW,Atalanta,it Serie A,25,1995,8.6,11,7,3,7,1,4,12,33.3,8,3,0,3,1,12,7,0,Matches,a9aa0d1d
1807,Juan Miranda,es ESP,DF,Betis,es La Liga,21,2000,8.7,21,11,16,4,1,12,22,54.5,10,10,4,6,15,36,22,0,Matches,ead61f73
1808,Fabio Miretti,it ITA,MF,Juventus,it Serie A,17,2003,3.6,4,2,2,2,0,2,9,22.2,7,3,1,2,2,6,3,0,Matches,34693494
1809,Tyrick Mitchell,eng ENG,DF,Crystal Palace,eng Premier League,21,1999,34.5,104,57,67,26,11,46,67,68.7,21,47,5,42,41,145,101,0,Matches,5cbd1eb0
1810,Stefan Mitrović,rs SRB,DF,Getafe,es La Liga,31,1990,29.6,16,8,12,4,0,8,13,61.5,5,28,18,10,22,38,114,1,Matches,e6777e6b
1811,Maximilian Mittelstädt,de GER,DFMF,Hertha BSC,de Bundesliga,24,1997,16.6,52,33,30,12,10,26,50,52.0,24,28,5,23,46,98,37,0,Matches,88d4144a
1812,Henrikh Mkhitaryan,am ARM,MF,Roma,it Serie A,32,1989,27.7,45,29,11,27,7,17,52,32.7,35,33,2,31,22,67,33,0,Matches,dd0daf32
1813,Jakub Moder,pl POL,MF,Brighton,eng Premier League,22,1999,18.9,42,25,18,17,7,23,42,54.8,19,25,2,23,10,52,22,1,Matches,f230bc30
1814,Anthony Modeste,fr FRA,FW,Köln,de Bundesliga,33,1988,29.0,10,6,4,5,1,3,18,16.7,15,11,2,9,4,14,29,0,Matches,34e4343c
1815,Marco Modolo,it ITA,DF,Venezia,it Serie A,32,1989,4.4,6,3,4,2,0,2,5,40.0,3,6,6,0,4,10,26,0,Matches,fdcdb521
1816,Luka Modrić,hr CRO,MF,Real Madrid,es La Liga,35,1985,22.6,18,10,8,7,3,6,27,22.2,21,10,4,6,20,38,9,0,Matches,6025fab1
1817,Terem Moffi,ng NGA,FW,Lorient,fr Ligue 1,22,1999,30.1,17,10,3,12,2,9,32,28.1,23,11,2,9,4,21,22,0,Matches,065dc209
1818,Kevin Möhwald,de GER,MF,Union Berlin,de Bundesliga,28,1993,3.9,7,1,3,3,1,1,7,14.3,6,3,0,3,3,10,6,0,Matches,a5ce09f2
1819,Dion Moise Sahi,ci CIV,FWMF,Strasbourg,fr Ligue 1,19,2001,1.4,0,0,0,0,0,0,0,,0,1,0,1,1,1,1,0,Matches,cdc4458b
1820,Johan Mojica,co COL,DF,Elche,es La Liga,28,1992,31.7,46,25,34,7,5,23,31,74.2,8,22,3,19,25,71,61,3,Matches,608f2092
1821,Clinton Mola,eng ENG,DF,Stuttgart,de Bundesliga,20,2001,1.3,3,1,2,1,0,2,4,50.0,2,5,5,0,3,6,2,0,Matches,29ddfb9c
1822,Jorge Molina,es ESP,FW,Granada,es La Liga,39,1982,21.8,4,2,2,1,1,2,18,11.1,16,13,2,11,6,10,11,0,Matches,43f71e77
1823,Nahuel Molina,ar ARG,DF,Udinese,it Serie A,23,1998,29.3,41,24,17,21,3,16,48,33.3,32,24,3,21,22,63,44,2,Matches,23610943
1824,Cristian Molinaro,it ITA,DF,Venezia,it Serie A,38,1983,6.1,12,9,10,2,0,5,7,71.4,2,7,2,5,6,18,20,0,Matches,1c8c5aed
1825,Florent Mollet,fr FRA,MF,Montpellier,fr Ligue 1,29,1991,29.2,31,22,14,12,5,14,57,24.6,43,27,4,23,24,55,13,0,Matches,7e82a78f
1826,Jon Moncayola,es ESP,MF,Osasuna,es La Liga,23,1998,32.4,40,20,18,18,4,17,44,38.6,27,26,9,17,20,60,43,0,Matches,9939e168
1827,Monchu,es ESP,MF,Granada,es La Liga,21,1999,7.4,15,6,5,9,1,5,10,50.0,5,8,3,5,4,19,4,0,Matches,8ac501f5
1828,Thomas Monconduit,fr FRA,MF,Lorient,fr Ligue 1,30,1991,25.0,41,25,19,17,5,20,57,35.1,37,21,10,11,22,63,51,1,Matches,84d94b91
1829,Gonzalo Montiel,ar ARG,DF,Sevilla,es La Liga,24,1997,11.8,15,4,8,5,2,12,24,50.0,12,8,2,6,10,25,22,0,Matches,374d5158
1830,Lorenzo Montipò,it ITA,GK,Hellas Verona,it Serie A,25,1996,34.0,0,0,0,0,0,0,0,,0,0,0,0,1,1,16,3,Matches,c1d95617
1831,Ángel Montoro,es ESP,MF,Granada,es La Liga,33,1988,14.8,26,13,16,7,3,17,27,63.0,10,11,1,10,11,37,29,1,Matches,719384c1
1832,Martín Montoya,es ESP,DF,Betis,es La Liga,30,1991,5.8,20,12,11,7,2,15,26,57.7,11,6,0,6,11,31,20,0,Matches,5cec2487
1833,Wesley Moraes,br BRA,FW,Aston Villa,eng Premier League,24,1996,0.0,0,0,0,0,0,0,0,,0,0,0,0,0,0,0,0,Matches,bfae110f
1834,Álvaro Morata,es ESP,FW,Juventus,it Serie A,28,1992,25.6,18,9,4,9,5,8,31,25.8,23,26,1,25,5,23,24,0,Matches,129af0db
1835,Jan Morávek,cz CZE,MF,Augsburg,de Bundesliga,31,1989,5.2,11,6,3,7,1,6,18,33.3,12,11,2,9,6,17,8,0,Matches,e7d22eae
1836,Jon Morcillo,es ESP,MFFW,Athletic Club,es La Liga,22,1998,0.6,3,0,1,2,0,3,4,75.0,1,1,0,1,0,3,0,0,Matches,b7d7f3bf
1837,Jérémy Morel,mg MAD,DF,Lorient,fr Ligue 1,37,1984,6.7,13,9,8,4,1,6,6,100.0,0,9,7,2,7,20,31,0,Matches,e97150c0
1838,Alberto Moreno,es ESP,MFDF,Villarreal,es La Liga,29,1992,13.6,13,7,5,7,1,5,18,27.8,13,13,1,12,27,40,15,0,Matches,11b9265b
1839,Álex Moreno,es ESP,DF,Betis,es La Liga,28,1993,26.7,76,40,53,15,8,33,60,55.0,27,28,6,22,34,110,82,1,Matches,16e9d0ea
1840,Gerard Moreno,es ESP,FW,Villarreal,es La Liga,29,1992,13.2,5,2,2,2,1,1,7,14.3,6,6,1,5,6,11,14,0,Matches,81f0781e
1841,Tete Morente,es ESP,MF,Elche,es La Liga,24,1996,18.1,21,14,13,7,1,7,28,25.0,21,30,1,29,12,33,12,0,Matches,004d185e
1842,Ilaix Moriba,gn GUI,MF,Valencia,es La Liga,18,2003,9.1,26,18,10,13,3,14,35,40.0,21,15,0,15,12,38,14,0,Matches,f4c69aa6
1843,Ilaix Moriba,gn GUI,MF,RB Leipzig,de Bundesliga,18,2003,0.4,0,0,0,0,0,0,4,0.0,4,2,0,2,1,1,0,0,Matches,f4c69aa6
1844,Manu Morlanes,es ESP,MF,Espanyol,es La Liga,22,1999,12.7,36,15,16,17,3,18,43,41.9,25,24,5,19,13,49,17,0,Matches,a0255c67
1845,Raúl Moro,es ESP,FW,Lazio,it Serie A,18,2002,2.2,3,3,0,2,1,1,5,20.0,4,2,0,2,0,3,0,0,Matches,919dd4b1
1846,Loren Morón,es ESP,FWMF,Espanyol,es La Liga,27,1993,6.3,6,4,1,3,2,0,12,0.0,12,11,1,10,2,8,9,0,Matches,3aa4a3be
1847,Loren Morón,es ESP,FW,Betis,es La Liga,27,1993,0.0,1,1,1,0,0,1,1,100.0,0,0,0,0,0,1,0,0,Matches,3aa4a3be
1848,Tyler Morton,eng ENG,MF,Liverpool,eng Premier League,18,2002,0.7,0,0,0,0,0,0,2,0.0,2,0,0,0,3,3,0,0,Matches,2bc28bb9
1849,Cristhian Mosquera,co COL,DF,Valencia,es La Liga,17,2004,2.4,4,2,3,0,1,3,6,50.0,3,1,0,1,3,7,1,1,Matches,dc1ce4f5
1850,Lebo Mothiba,za RSA,FWMF,Troyes,fr Ligue 1,25,1996,5.8,8,4,4,3,1,2,5,40.0,3,3,0,3,2,10,0,0,Matches,3eaf8817
1851,Lebo Mothiba,za RSA,FW,Strasbourg,fr Ligue 1,25,1996,0.0,0,0,0,0,0,0,0,,0,0,0,0,0,0,0,0,Matches,3eaf8817
1852,Andrei Motoc,ro ROU,DF,Salernitana,it Serie A,19,2002,1.0,1,1,0,1,0,0,0,,0,2,2,0,2,3,1,0,Matches,b64073a0
1853,Baptiste Mouazan,fr FRA,MF,Lorient,fr Ligue 1,19,2001,1.1,4,3,2,2,0,1,3,33.3,2,3,0,3,1,5,1,0,Matches,81ac108d
1854,Aimen Moueffek,fr FRA,MF,Saint-Étienne,fr Ligue 1,20,2001,4.8,7,4,2,3,2,2,8,25.0,6,3,0,3,2,9,4,0,Matches,2591b066
1855,Youssoufa Moukoko,de GER,FWMF,Dortmund,de Bundesliga,16,2004,2.5,1,0,0,1,0,0,1,0.0,1,5,0,5,3,4,0,0,Matches,6ce43701
1856,Harold Moukoudi,cm CMR,DF,Saint-Étienne,fr Ligue 1,23,1997,18.5,25,12,17,8,0,14,25,56.0,11,27,14,13,35,60,48,0,Matches,5f26e0c5
1857,Jessy Moulin,fr FRA,GK,Troyes,fr Ligue 1,35,1986,7.0,0,0,0,0,0,0,0,,0,0,0,0,1,1,7,0,Matches,28a65a2c
1858,Steve Mounié,bj BEN,FW,Brest,fr Ligue 1,26,1994,25.7,17,6,3,12,2,4,27,14.8,23,13,1,12,6,23,12,0,Matches,19ba6c6d
1859,Mason Mount,eng ENG,MF,Chelsea,eng Premier League,22,1999,26.3,41,16,10,17,14,10,34,29.4,24,18,1,17,13,54,12,0,Matches,9674002f
1860,Lucas Moura,br BRA,MFFW,Tottenham,eng Premier League,28,1992,19.7,25,10,7,14,4,8,35,22.9,27,19,0,19,18,43,19,0,Matches,2b622f01
1861,Lys Mousset,fr FRA,MFFW,Salernitana,it Serie A,25,1996,1.8,1,0,0,1,0,0,0,,0,2,0,2,0,1,0,0,Matches,d9cfca3d
1862,João Moutinho,pt POR,MF,Wolves,eng Premier League,34,1986,33.0,74,39,34,27,13,30,106,28.3,76,48,8,40,34,108,36,2,Matches,f5a00fa4
1863,Samuel Moutoussamy,cd COD,MF,Nantes,fr Ligue 1,24,1996,16.8,48,32,20,20,8,23,62,37.1,39,14,2,12,17,65,16,0,Matches,af0c835b
1864,Toni Moya,es ESP,MF,Alavés,es La Liga,23,1998,15.4,23,10,7,13,3,13,43,30.2,30,18,5,13,20,43,18,0,Matches,9e098912
1865,Samuel Mráz,sk SVK,FW,Spezia,it Serie A,24,1997,0.6,0,0,0,0,0,0,0,,0,1,0,1,0,0,0,0,Matches,be6c1ccc
1866,Nordi Mukiele,fr FRA,DFFW,RB Leipzig,de Bundesliga,23,1997,20.5,35,22,23,9,3,14,27,51.9,13,31,5,26,31,66,44,2,Matches,ac73ec79
1867,Mert Müldür,tr TUR,DF,Sassuolo,it Serie A,22,1999,22.7,52,35,43,7,2,27,49,55.1,22,25,6,19,24,76,44,1,Matches,1295552e
1868,Florian Müller,de GER,GK,Stuttgart,de Bundesliga,23,1997,30.0,0,0,0,0,0,0,1,0.0,1,1,0,1,0,0,13,2,Matches,cbac6ec9
1869,Thomas Müller,de GER,MF,Bayern Munich,de Bundesliga,31,1989,28.4,35,20,7,16,12,16,54,29.6,38,32,1,31,15,50,12,0,Matches,3c6089ab
1870,Bali Mumba,eng ENG,DF,Norwich City,eng Premier League,19,2001,0.5,1,1,1,0,0,0,0,,0,0,0,0,0,1,5,0,Matches,2d760d7b
1871,Marshall Munetsi,zw ZIM,MFDF,Reims,fr Ligue 1,25,1996,20.9,34,17,21,11,2,17,39,43.6,22,39,13,26,43,77,72,2,Matches,2acf0cd7
1872,Iker Muniain,es ESP,MF,Athletic Club,es La Liga,28,1992,30.9,32,10,8,19,5,12,40,30.0,28,20,1,19,17,49,8,1,Matches,c05dfb74
1873,Aihen Muñoz,es ESP,DF,Real Sociedad,es La Liga,23,1997,14.9,28,17,14,13,1,18,29,62.1,11,11,1,10,17,45,34,0,Matches,228b0d9d
1874,Luis Muriel,co COL,FWMF,Atalanta,it Serie A,30,1991,17.1,15,4,2,7,6,3,19,15.8,16,12,0,12,4,19,5,0,Matches,eb2fe5b6
1875,Jeison Murillo,co COL,DF,Celta Vigo,es La Liga,29,1992,12.4,15,10,13,2,0,9,13,69.2,4,11,8,3,17,32,37,0,Matches,b233e8e4
1876,Vedat Muriqi,xk KVX,FW,Lazio,it Serie A,27,1994,2.4,1,0,1,0,0,0,5,0.0,5,0,0,0,0,1,2,0,Matches,0cadc46d
1877,Vedat Muriqi,xk KVX,FW,Mallorca,es La Liga,27,1994,16.0,6,3,1,3,2,1,7,14.3,6,12,0,12,6,12,29,0,Matches,0cadc46d
1878,Jacob Murphy,eng ENG,FWDF,Newcastle Utd,eng Premier League,26,1995,16.4,49,26,34,11,4,26,41,63.4,15,20,2,18,23,72,17,0,Matches,de112b84
1879,Nicola Murru,it ITA,DF,Sampdoria,it Serie A,26,1994,10.9,22,17,10,11,1,8,13,61.5,5,17,3,14,7,29,20,1,Matches,d183e9d6
1880,Yunus Musah,us USA,MFFW,Valencia,es La Liga,18,2002,14.0,23,13,8,8,7,6,20,30.0,14,19,1,18,14,37,11,0,Matches,b51b1b9c
1881,Torben Müsel,de GER,MF,M'Gladbach,de Bundesliga,22,1999,0.1,0,0,0,0,0,0,0,,0,0,0,0,0,0,0,0,Matches,d01b9ad6
1882,Jamal Musiala,de GER,MF,Bayern Munich,de Bundesliga,18,2003,16.3,40,26,11,16,13,15,36,41.7,21,25,0,25,19,59,2,1,Matches,2c0558b8
1883,Juan Musso,ar ARG,GK,Atalanta,it Serie A,27,1994,32.6,1,1,1,0,0,0,0,,0,0,0,0,0,1,17,1,Matches,a111cf41
1884,Shkodran Mustafi,de GER,DF,Levante,es La Liga,29,1992,7.3,9,6,6,3,0,5,9,55.6,4,6,3,3,15,24,40,0,Matches,3f2d59fe
1885,Junior Mwanga,fr FRA,DF,Bordeaux,fr Ligue 1,18,2003,1.0,5,2,4,1,0,3,3,100.0,0,1,0,1,0,5,1,0,Matches,ee158be5
1886,Enock Mwepu,zm ZAM,MF,Brighton,eng Premier League,23,1998,11.1,22,12,10,10,2,5,27,18.5,22,20,2,18,12,34,19,0,Matches,1d5cab82
1887,Vitaliy Mykolenko,ua UKR,DF,Everton,eng Premier League,22,1999,11.7,25,15,15,7,3,12,21,57.1,9,15,2,13,16,41,37,0,Matches,30d4a2e5
1888,Joakim Mæhle,dk DEN,DFMF,Atalanta,it Serie A,24,1997,16.3,21,11,6,9,6,12,27,44.4,15,18,2,16,14,35,13,0,Matches,c459a650
1889,Obite N'Dicka,fr FRA,DF,Eint Frankfurt,de Bundesliga,21,1999,31.7,60,34,29,27,4,44,59,74.6,15,46,20,26,48,108,137,0,Matches,441197b8
1890,Kévin N'Doram,fr FRA,MF,Metz,fr Ligue 1,25,1996,13.7,10,8,3,5,2,3,20,15.0,17,24,5,19,19,29,21,0,Matches,e50623a0
1891,Eric N'Jo,fr FRA,DF,Troyes,fr Ligue 1,17,2004,1.1,0,0,0,0,0,0,1,0.0,1,1,1,0,2,2,1,0,Matches,b85e57bb
1892,Vital N'Simba,cd COD,DF,Clermont Foot,fr Ligue 1,28,1993,31.0,66,45,38,23,5,36,63,57.1,27,28,7,21,29,95,30,0,Matches,249ac66d
1893,Nacho,es ESP,DF,Real Madrid,es La Liga,31,1990,17.3,18,14,9,9,0,12,22,54.5,10,22,15,7,34,52,50,0,Matches,2946f9a1
1894,Mickael Nade,fr FRA,DF,Saint-Étienne,fr Ligue 1,22,1999,28.5,57,35,37,18,2,23,38,60.5,15,29,15,14,60,117,84,0,Matches,a6b6fa6e
1895,Marvelous Nakamba,zw ZIM,MF,Aston Villa,eng Premier League,27,1994,10.0,32,19,18,14,0,12,34,35.3,22,14,4,10,12,44,17,1,Matches,de5b5570
1896,Nahitan Nández,uy URU,MFDF,Cagliari,it Serie A,25,1995,16.9,39,21,16,15,8,18,33,54.5,15,16,1,15,9,48,15,1,Matches,95facda1
1897,Nani,pt POR,MFFW,Venezia,it Serie A,34,1986,3.2,2,1,1,1,0,0,1,0.0,1,1,0,1,2,4,0,1,Matches,15e9c7e6
1898,Paul Nardi,fr FRA,GK,Lorient,fr Ligue 1,27,1994,22.0,1,0,1,0,0,1,2,50.0,1,0,0,0,0,1,10,2,Matches,2d70dbe5
1899,Nikolas Nartey,dk DEN,MFDF,Stuttgart,de Bundesliga,21,2000,4.5,6,3,0,5,1,3,9,33.3,6,4,2,2,7,13,5,0,Matches,30261ba1
1900,Matija Nastasić,rs SRB,DF,Fiorentina,it Serie A,28,1993,2.4,1,1,1,0,0,1,1,100.0,0,1,1,0,5,6,11,0,Matches,f35430a4
1901,Roberto Navarro,es ESP,MFFW,Real Sociedad,es La Liga,19,2002,2.2,5,3,1,1,3,3,5,60.0,2,2,0,2,2,7,2,0,Matches,c997b942
1902,Ximo Navarro,es ESP,DF,Alavés,es La Liga,31,1990,15.0,28,19,21,6,1,13,27,48.1,14,11,5,6,22,50,56,2,Matches,8db394aa
1903,Jesús Navas,es ESP,DF,Sevilla,es La Liga,35,1985,19.8,18,13,11,5,2,9,18,50.0,9,15,2,13,17,35,26,1,Matches,3f10bd22
1904,Keylor Navas,cr CRC,GK,Paris S-G,fr Ligue 1,34,1986,20.6,0,0,0,0,0,0,0,,0,0,0,0,0,0,5,1,Matches,ecada4fc
1905,Papa Ndiaga Yade,sn SEN,DFFW,Metz,fr Ligue 1,21,2000,7.7,15,10,8,7,0,8,18,44.4,10,4,1,3,10,25,9,0,Matches,87e9c7cd
1906,Loum Ndiaye,sn SEN,MF,Alavés,es La Liga,24,1996,25.7,49,22,26,22,1,17,45,37.8,28,30,11,19,37,86,68,1,Matches,bcfc4473
1907,Wilfred Ndidi,ng NGA,MFDF,Leicester City,eng Premier League,24,1996,18.0,60,32,32,27,1,22,55,40.0,33,36,8,28,42,102,54,1,Matches,6b47c5db
1908,Tanguy Ndombele,fr FRA,MF,Tottenham,eng Premier League,24,1996,5.4,10,7,3,5,2,1,8,12.5,7,5,0,5,1,11,1,0,Matches,5cdddffa
1909,Tanguy Ndombele,fr FRA,MF,Lyon,fr Ligue 1,24,1996,7.8,25,14,5,17,3,12,19,63.2,7,8,3,5,3,28,6,2,Matches,5cdddffa
1910,Dan Ndoye,ch SUI,FWMF,Nice,fr Ligue 1,20,2000,2.3,0,0,0,0,0,0,2,0.0,2,4,0,4,0,0,0,0,Matches,8e697a8f
1911,Paul Nebel,de GER,MFFW,Mainz 05,de Bundesliga,18,2002,2.5,5,3,3,1,1,2,3,66.7,1,0,0,0,0,5,1,0,Matches,1b6d8083
1912,Álvaro Negredo,es ESP,FW,Cádiz,es La Liga,35,1985,24.0,5,3,1,4,0,3,6,50.0,3,11,5,6,2,7,23,0,Matches,63b0ca6b
1913,Reiss Nelson,eng ENG,MF,Arsenal,eng Premier League,21,1999,0.2,1,0,0,0,1,0,1,0.0,1,1,0,1,0,1,0,0,Matches,c5bdb6e3
1914,David Nemeth,at AUT,DF,Mainz 05,de Bundesliga,20,2001,3.5,3,2,2,1,0,1,3,33.3,2,5,1,4,6,9,11,1,Matches,da76715c
1915,Ilija Nestorovski,mk MKD,FW,Udinese,it Serie A,31,1990,2.1,0,0,0,0,0,0,3,0.0,3,0,0,0,0,0,4,0,Matches,b1236c63
1916,Neto,br BRA,GK,Barcelona,es La Liga,32,1989,3.0,0,0,0,0,0,0,0,,0,0,0,0,0,0,2,1,Matches,a9dc785c
1917,Pedro Neto,pt POR,MFFW,Wolves,eng Premier League,21,2000,5.2,4,4,2,0,2,0,9,0.0,9,0,0,0,6,10,1,0,Matches,7ba2eaa9
1918,Luca Netz,de GER,DF,M'Gladbach,de Bundesliga,18,2003,15.5,25,11,13,10,2,12,41,29.3,29,24,4,20,13,38,36,1,Matches,e79269bd
1919,Manuel Neuer,de GER,GK,Bayern Munich,de Bundesliga,35,1986,27.9,2,1,2,0,0,1,2,50.0,1,0,0,0,0,2,7,1,Matches,8778c910
1920,Florian Neuhaus,de GER,MF,M'Gladbach,de Bundesliga,24,1997,23.6,55,28,24,26,5,27,65,41.5,38,38,6,32,31,86,25,4,Matches,36a59ba4
1921,Carlos Neva,es ESP,DF,Granada,es La Liga,25,1996,23.4,31,19,24,7,0,16,28,57.1,12,27,9,18,32,63,81,0,Matches,8d47bb39
1922,Rúben Neves,pt POR,MF,Wolves,eng Premier League,24,1997,29.6,68,37,23,41,4,24,87,27.6,63,39,5,34,41,109,49,3,Matches,44bfb6c5
1923,Neymar,br BRA,FWMF,Paris S-G,fr Ligue 1,29,1992,20.6,29,19,5,12,12,12,36,33.3,24,9,1,8,4,33,2,1,Matches,69384e5d
1924,Yvan Neyou,cm CMR,MF,Saint-Étienne,fr Ligue 1,24,1997,10.4,29,13,14,12,3,9,27,33.3,18,8,3,5,23,52,13,0,Matches,0ad37003
1925,Jeremy Ngakia,eng ENG,DF,Watford,eng Premier League,20,2000,10.0,31,18,23,5,3,11,26,42.3,15,11,4,7,12,43,32,0,Matches,3631ad41
1926,Jessic Ngankam,de GER,FW,Greuther Fürth,de Bundesliga,21,2000,3.8,3,1,1,1,1,1,2,50.0,1,3,0,3,0,3,1,0,Matches,bc249af8
1927,Opa Nguette,sn SEN,FWMF,Metz,fr Ligue 1,27,1994,11.6,21,14,9,6,6,5,14,35.7,9,13,3,10,2,23,9,0,Matches,75a63397
1928,Aurélien Nguiamba,fr FRA,MF,Spezia,it Serie A,22,1999,0.6,3,2,1,2,0,2,3,66.7,1,2,1,1,0,3,1,0,Matches,de135234
1929,Sikou Niakaté,fr FRA,DF,Metz,fr Ligue 1,22,1999,7.3,8,7,8,0,0,4,11,36.4,7,5,3,2,27,35,34,0,Matches,8eef18aa
1930,Moussa Niakhate,fr FRA,DF,Mainz 05,de Bundesliga,25,1996,28.5,40,23,25,13,2,20,33,60.6,13,37,11,26,50,90,69,1,Matches,00242715
1931,Ibrahima Niane,sn SEN,FW,Metz,fr Ligue 1,22,1999,17.6,1,1,0,1,0,0,5,0.0,5,6,1,5,3,4,16,0,Matches,46faabfa
1932,M'Baye Niang,sn SEN,FW,Bordeaux,fr Ligue 1,26,1994,8.6,4,0,0,2,2,0,4,0.0,4,9,1,8,1,5,4,0,Matches,2054d037
1933,Tanguy Nianzou,fr FRA,DF,Bayern Munich,de Bundesliga,19,2002,6.5,11,7,7,3,1,7,11,63.6,4,7,2,5,7,18,17,0,Matches,5853ac44
1934,Cheikh Niasse,sn SEN,FWMF,Lille,fr Ligue 1,21,2000,0.5,2,2,0,2,0,2,3,66.7,1,1,1,0,1,3,2,0,Matches,ff20acfe
1935,Florian Niederlechner,de GER,FW,Augsburg,de Bundesliga,30,1990,12.9,6,5,1,3,2,4,13,30.8,9,9,0,9,4,10,7,0,Matches,d6862409
1936,Håvard Nielsen,no NOR,MFFW,Greuther Fürth,de Bundesliga,28,1993,15.2,17,12,5,11,1,8,21,38.1,13,18,1,17,7,24,22,0,Matches,b18ef366
1937,Saúl Ñíguez,es ESP,DFMF,Chelsea,eng Premier League,26,1994,5.3,20,9,11,9,0,9,16,56.3,7,14,3,11,7,27,10,1,Matches,c14bc029
1938,Saúl Ñíguez,es ESP,FWMF,Atlético Madrid,es La Liga,26,1994,2.2,7,2,0,6,1,3,4,75.0,1,7,1,6,0,7,3,0,Matches,c14bc029
1939,Dimitris Nikolaou,gr GRE,DF,Spezia,it Serie A,22,1998,36.0,39,26,29,7,3,22,34,64.7,12,48,24,24,49,88,132,1,Matches,cf961d8d
1940,Joakim Nilsson,se SWE,DF,Arminia,de Bundesliga,27,1994,30.4,37,19,24,13,0,20,26,76.9,6,36,23,13,56,93,144,1,Matches,c562c5b4
1941,Casimir Ninga,td CHA,FW,Angers,fr Ligue 1,28,1993,4.5,5,1,1,4,0,2,5,40.0,3,2,0,2,1,6,0,0,Matches,91f2da4c
1942,Fernando Niño,es ESP,FW,Mallorca,es La Liga,20,2000,9.8,10,4,3,2,5,2,12,16.7,10,9,2,7,3,13,15,0,Matches,81d5c497
1943,Eddie Nketiah,eng ENG,FW,Arsenal,eng Premier League,22,1999,9.3,9,4,1,4,4,1,4,25.0,3,9,2,7,4,13,5,0,Matches,a53649b7
1944,Nicolas Nkoulou,cm CMR,DF,Watford,eng Premier League,31,1990,1.9,1,0,0,1,0,0,0,,0,2,1,1,2,3,8,0,Matches,93cf32a8
1945,Christopher Nkunku,fr FRA,FWMF,RB Leipzig,de Bundesliga,23,1997,30.3,23,10,10,11,2,9,35,25.7,26,23,2,21,15,38,15,0,Matches,7c56da38
1946,Lukas Nmecha,de GER,FWMF,Wolfsburg,de Bundesliga,22,1998,18.1,12,5,5,5,2,5,19,26.3,14,9,1,8,4,16,10,0,Matches,0cc5f4a5
1947,Mark Noble,eng ENG,MF,West Ham,eng Premier League,34,1987,3.7,8,2,7,1,0,5,11,45.5,6,4,1,3,4,12,2,1,Matches,ff527768
1948,Peru Nolaskoain,es ESP,DF,Athletic Club,es La Liga,22,1998,0.0,0,0,0,0,0,0,0,,0,0,0,0,0,0,0,0,Matches,857cb4f3
1949,Nolito,es ESP,MF,Celta Vigo,es La Liga,34,1986,15.4,25,15,14,7,4,13,47,27.7,34,20,1,19,9,34,5,0,Matches,b2d0ec1b
1950,Arnaud Nordin,fr FRA,MFFW,Saint-Étienne,fr Ligue 1,23,1998,20.8,21,11,8,8,5,8,22,36.4,14,19,0,19,6,27,8,0,Matches,7b9a9e25
1951,Håvard Nordtveit,no NOR,DF,Hoffenheim,de Bundesliga,31,1990,3.4,7,6,2,4,1,4,4,100.0,0,2,1,1,10,17,11,0,Matches,6cafd68d
1952,Mathias Normann,no NOR,MF,Norwich City,eng Premier League,25,1996,18.3,34,21,19,14,1,17,46,37.0,29,17,8,9,19,53,43,1,Matches,8996350d
1953,Connor Noß,ie IRL,MF,M'Gladbach,de Bundesliga,20,2001,0.6,1,0,0,1,0,0,1,0.0,1,1,1,0,0,1,0,0,Matches,ccc6d365
1954,Hugo Novoa,es ESP,MFFW,RB Leipzig,de Bundesliga,18,2003,1.5,4,4,2,0,2,2,7,28.6,5,2,0,2,1,5,0,0,Matches,5458f670
1955,Soma Novothny,hu HUN,FWMF,Bochum,de Bundesliga,27,1994,0.9,1,1,1,0,0,0,1,0.0,1,1,0,1,0,1,2,0,Matches,6fb91ea9
1956,Jean-Pierre Nsame,cm CMR,FW,Venezia,it Serie A,28,1993,2.7,1,1,0,0,1,0,0,,0,0,0,0,0,1,1,0,Matches,12e6d21a
1957,Randy Ntekja,fr FRA,FWMF,Rayo Vallecano,es La Liga,23,1997,16.2,24,13,9,11,4,8,19,42.1,11,21,1,20,8,32,12,0,Matches,a6103274
1958,Alexander Nübel,de GER,GK,Monaco,fr Ligue 1,24,1996,38.0,0,0,0,0,0,0,0,,0,0,0,0,0,0,11,1,Matches,afb0c500
1959,Kasim Nuhu,gh GHA,DF,Hoffenheim,de Bundesliga,26,1995,0.1,0,0,0,0,0,0,1,0.0,1,0,0,0,0,0,1,0,Matches,93a50d2c
1960,Unai Núñez,es ESP,DF,Athletic Club,es La Liga,24,1997,6.9,4,4,2,2,0,3,6,50.0,3,9,8,1,8,12,26,2,Matches,be170419
1961,Hans Nunoo Sarpei,gh GHA,DFMF,Greuther Fürth,de Bundesliga,22,1998,7.1,16,11,9,7,0,10,14,71.4,4,8,5,3,14,30,21,0,Matches,9593331d
1962,Bram Nuytinck,nl NED,DF,Udinese,it Serie A,31,1990,22.6,38,24,24,13,1,15,34,44.1,19,42,31,11,22,60,101,0,Matches,e33f36d5
1963,Simeon Nwankwo,ng NGA,FW,Salernitana,it Serie A,29,1992,9.4,5,5,0,4,1,4,10,40.0,6,8,3,5,3,8,10,0,Matches,80dbbd10
1964,Gerzino Nyamsi,fr FRA,DF,Strasbourg,fr Ligue 1,24,1997,33.2,35,21,24,9,2,20,27,74.1,7,25,16,9,25,60,90,1,Matches,6043997c
1965,Allan Nyom,cm CMR,DF,Getafe,es La Liga,33,1988,2.7,3,1,2,1,0,2,2,100.0,0,2,1,1,2,5,7,0,Matches,97572117
1966,M'Bala Nzola,ao ANG,FW,Spezia,it Serie A,24,1996,11.9,2,2,0,0,2,1,6,16.7,5,8,0,8,0,2,13,0,Matches,a4948e67
1967,Christian Nørgaard,dk DEN,MF,Brentford,eng Premier League,27,1994,33.9,109,60,42,58,9,52,101,51.5,49,48,9,39,64,173,58,1,Matches,df0a4c90
1968,Adam Obert,sk SVK,DFMF,Cagliari,it Serie A,18,2002,3.0,8,5,6,2,0,5,6,83.3,1,6,4,2,4,12,11,0,Matches,aa25ce92
1969,Joel Obi,ng NGA,MFDF,Salernitana,it Serie A,30,1991,12.7,23,14,5,14,4,5,12,41.7,7,17,6,11,10,33,7,0,Matches,614c38fb
1970,Jan Oblak,si SVN,GK,Atlético Madrid,es La Liga,28,1993,38.0,0,0,0,0,0,0,0,,0,0,0,0,1,1,10,4,Matches,ee8508c0
1971,Lucas Ocampos,ar ARG,FWMF,Sevilla,es La Liga,27,1994,23.6,45,24,23,18,4,23,55,41.8,32,35,1,34,9,54,24,1,Matches,a08b974a
1972,Bastian Oczipka,de GER,DF,Union Berlin,de Bundesliga,32,1989,10.4,24,15,15,7,2,10,13,76.9,3,10,2,8,12,36,21,0,Matches,d1661819
1973,Brain Oddei,it ITA,MFFW,Sassuolo,it Serie A,18,2002,0.1,0,0,0,0,0,0,0,,0,0,0,0,0,0,0,0,Matches,97e8ea97
1974,Álvaro Odriozola,es ESP,DF,Fiorentina,it Serie A,25,1995,19.3,25,15,12,6,7,15,32,46.9,17,17,6,11,8,33,25,2,Matches,1d1691ad
1975,Angelo Ogbonna,it ITA,DF,West Ham,eng Premier League,33,1988,10.2,7,4,5,2,0,3,7,42.9,4,5,4,1,11,18,29,0,Matches,74b2cd7e
1976,Florent Ogier,fr FRA,DF,Clermont Foot,fr Ligue 1,32,1989,27.0,31,17,18,12,1,17,31,54.8,14,41,27,14,37,68,89,0,Matches,6993927b
1977,Stefano Okaka,it ITA,FW,Udinese,it Serie A,31,1989,0.2,0,0,0,0,0,0,0,,0,2,0,2,0,0,1,0,Matches,601ef102
1978,David Okereke,ng NGA,FWMF,Venezia,it Serie A,23,1997,22.8,16,10,4,9,3,3,20,15.0,17,19,3,16,10,26,20,0,Matches,d125f22f
1979,Masaya Okugawa,jp JPN,MFFW,Arminia,de Bundesliga,25,1996,28.1,46,25,18,22,6,12,37,32.4,25,29,1,28,20,66,13,0,Matches,63b9cc6d
1980,Lucas Olaza,uy URU,DF,Elche,es La Liga,27,1994,3.3,5,3,3,1,1,1,1,100.0,0,5,1,4,4,9,6,0,Matches,4cee5954
1981,Oier Olazábal,es ESP,GK,Espanyol,es La Liga,31,1989,1.5,0,0,0,0,0,0,0,,0,0,0,0,0,0,0,0,Matches,b5bdf144
1982,Mathias Olesen,lu LUX,MFFW,Köln,de Bundesliga,20,2001,0.2,0,0,0,0,0,0,0,,0,0,0,0,1,1,0,0,Matches,86adbcc7
1983,Michael Olise,fr FRA,FWMF,Crystal Palace,eng Premier League,19,2001,12.7,22,18,8,11,3,7,24,29.2,17,17,0,17,6,28,6,0,Matches,c4486bac
1984,Christian Oliva,uy URU,MF,Cagliari,it Serie A,25,1996,0.5,2,2,2,0,0,1,4,25.0,3,0,0,0,0,2,0,0,Matches,d3b888e3
1985,Brian Oliván,es ESP,DF,Mallorca,es La Liga,27,1994,24.3,33,20,22,9,2,12,23,52.2,11,17,7,10,28,61,63,0,Matches,a3e4bf46
1986,Sérgio Oliveira,pt POR,MF,Roma,it Serie A,29,1992,9.9,27,14,11,14,2,15,30,50.0,15,13,0,13,10,37,7,0,Matches,947e036f
1987,Mathías Olivera,uy URU,DF,Getafe,es La Liga,23,1997,31.1,79,47,39,34,6,40,69,58.0,29,45,4,41,55,134,67,1,Matches,41c12f75
1988,Dani Olmo,es ESP,MFFW,RB Leipzig,de Bundesliga,23,1998,8.3,14,6,5,7,2,5,18,27.8,13,5,1,4,4,18,1,0,Matches,ae44e8e2
1989,Robin Olsen,se SWE,GK,Aston Villa,eng Premier League,31,1990,1.0,0,0,0,0,0,0,0,,0,0,0,0,0,0,0,0,Matches,e7ee38c3
1990,Warmed Omari,fr FRA,DF,Rennes,fr Ligue 1,21,2000,31.1,33,17,22,10,1,15,23,65.2,8,20,13,7,31,64,94,5,Matches,4534a352
1991,Jonas Omlin,ch SUI,GK,Montpellier,fr Ligue 1,27,1994,28.7,2,1,2,0,0,2,3,66.7,1,0,0,0,0,2,12,3,Matches,c631f952
1992,Andrew Omobamidele,ie IRL,DF,Norwich City,eng Premier League,19,2002,4.2,8,6,5,3,0,5,11,45.5,6,8,8,0,5,13,13,0,Matches,c393a6c4
1993,Amadou Onana,be BEL,MF,Lille,fr Ligue 1,19,2001,15.1,48,31,17,27,4,18,25,72.0,7,10,3,7,30,78,19,0,Matches,828657ff
1994,Jean Onana,cm CMR,MF,Bordeaux,fr Ligue 1,21,2000,20.4,70,49,33,33,4,35,86,40.7,51,37,5,32,36,106,23,1,Matches,b5bb8188
1995,Karim Onisiwo,at AUT,FW,Mainz 05,de Bundesliga,29,1992,26.2,18,10,4,6,8,7,22,31.8,15,27,2,25,7,25,8,0,Matches,f26834c7
1996,Javier Ontiveros,es ESP,FWMF,Osasuna,es La Liga,23,1997,0.4,0,0,0,0,0,0,2,0.0,2,0,0,0,1,1,0,1,Matches,a83d8b0c
1997,Tyler Onyango,eng ENG,MF,Everton,eng Premier League,18,2003,0.3,0,0,0,0,0,0,0,,0,0,0,0,0,0,1,0,Matches,d86a1f3e
1998,Frank Onyeka,ng NGA,MF,Brentford,eng Premier League,23,1998,11.6,25,17,13,9,3,8,27,29.6,19,16,2,14,14,39,13,0,Matches,2944f86f
1999,Willi Orban,hu HUN,DF,RB Leipzig,de Bundesliga,28,1992,29.4,32,22,20,11,1,13,25,52.0,12,40,24,16,44,76,123,2,Matches,20030c06
2000,Divock Origi,be BEL,FW,Liverpool,eng Premier League,26,1995,1.5,0,0,0,0,0,0,2,0.0,2,1,0,1,1,1,2,0,Matches,43a166b4
2001,Riccardo Orsolini,it ITA,FWMF,Bologna,it Serie A,24,1997,19.8,22,14,10,11,1,13,29,44.8,16,9,4,5,5,27,14,0,Matches,e14ec482
2002,Stefan Ortega,de GER,GK,Arminia,de Bundesliga,28,1992,33.0,1,0,1,0,0,1,2,50.0,1,2,0,2,0,1,5,1,Matches,c1242d4e
2003,Pedro Ortiz,es ESP,MF,Sevilla,es La Liga,20,2000,0.1,0,0,0,0,0,0,0,,0,0,0,0,0,0,1,0,Matches,f9358b61
2004,Victor Osimhen,ng NGA,FW,Napoli,it Serie A,22,1998,22.0,10,5,1,2,7,2,6,33.3,4,16,3,13,3,13,17,0,Matches,8c90fd7a
2005,Milutin Osmajić,me MNE,FWMF,Cádiz,es La Liga,22,1999,2.9,1,1,0,1,0,0,0,,0,0,0,0,1,2,3,0,Matches,375ed9d7
2006,David Ospina,co COL,GK,Napoli,it Serie A,32,1988,31.0,0,0,0,0,0,0,0,,0,0,0,0,1,1,11,1,Matches,82b1198a
2007,Patrick Osterhage,de GER,MF,Bochum,de Bundesliga,21,2000,6.7,9,6,3,5,1,3,7,42.9,4,7,1,6,11,20,8,0,Matches,9662c9ec
2008,Tomáš Ostrák,cz CZE,MFFW,Köln,de Bundesliga,21,2000,0.3,1,0,0,0,1,1,3,33.3,2,0,0,0,1,2,0,0,Matches,3ba95f20
2009,Otávio,br BRA,MF,Bordeaux,fr Ligue 1,27,1994,12.7,36,23,13,21,2,16,39,41.0,23,9,3,6,18,54,11,0,Matches,243f4a0b
2010,Paulo Otávio,br BRA,DFMF,Wolfsburg,de Bundesliga,26,1994,4.0,14,10,7,4,3,8,15,53.3,7,11,6,5,4,18,9,0,Matches,1cbe4984
2011,Dango Ouattara,bf BFA,MFFW,Lorient,fr Ligue 1,19,2002,9.0,21,15,9,11,1,11,23,47.8,12,10,1,9,14,35,15,1,Matches,2f9e4435
2012,Remi Oudin,fr FRA,MFDF,Bordeaux,fr Ligue 1,24,1996,19.3,34,18,19,13,2,18,32,56.3,14,14,3,11,27,61,21,0,Matches,ea02beaf
2013,Alexandre Oukidja,dz ALG,GK,Metz,fr Ligue 1,33,1988,20.8,0,0,0,0,0,0,1,0.0,1,1,0,1,1,1,17,2,Matches,ae7d0ecd
2014,Azzedine Ounahi,ma MAR,MF,Angers,fr Ligue 1,21,2000,18.1,39,22,16,22,1,11,40,27.5,29,19,1,18,26,65,13,0,Matches,83299cc0
2015,Adam Ounas,dz ALG,MFFW,Napoli,it Serie A,24,1996,3.6,6,1,0,3,3,3,7,42.9,4,3,0,3,2,8,3,0,Matches,ed90babd
2016,Jesús Owono,gq EQG,GK,Alavés,es La Liga,20,2001,1.0,0,0,0,0,0,0,0,,0,0,0,0,0,0,1,0,Matches,d6e3d7fb
2017,Reece Oxford,eng ENG,DF,Augsburg,de Bundesliga,22,1998,29.9,27,14,16,9,2,15,31,48.4,16,42,33,9,72,99,172,1,Matches,8b6e0db2
2018,Alex Oxlade-Chamberlain,eng ENG,MFFW,Liverpool,eng Premier League,27,1993,8.7,15,11,2,8,5,3,14,21.4,11,12,2,10,6,21,5,0,Matches,38c7feef
2019,Mikel Oyarzabal,es ESP,MFFW,Real Sociedad,es La Liga,24,1997,18.6,18,10,7,7,4,7,21,33.3,14,18,2,16,10,28,16,1,Matches,8c3c640c
2020,Ambroise Oyongo,cm CMR,DF,Montpellier,fr Ligue 1,30,1991,7.3,13,4,7,4,2,9,15,60.0,6,5,1,4,6,19,17,0,Matches,e3e05edf
2021,Salih Özcan,tr TUR,MF,Köln,de Bundesliga,23,1998,25.7,42,30,14,23,5,22,51,43.1,29,37,5,32,51,93,35,1,Matches,15413fa5
2022,Levin Öztunalı,de GER,MF,Union Berlin,de Bundesliga,25,1996,6.4,14,11,6,5,3,7,17,41.2,10,3,0,3,4,18,12,0,Matches,66385c46
2023,Fernando Pacheco,es ESP,GK,Alavés,es La Liga,29,1992,33.9,2,1,2,0,0,2,2,100.0,0,0,0,0,0,2,18,1,Matches,97852360
2024,Jon Pacheco,es ESP,DF,Real Sociedad,es La Liga,20,2001,4.2,6,4,4,2,0,3,3,100.0,0,6,4,2,6,12,18,0,Matches,44150beb
2025,Gonçalo Paciência,pt POR,FW,Eint Frankfurt,de Bundesliga,26,1994,5.7,4,2,2,1,1,1,3,33.3,2,2,0,2,1,5,4,0,Matches,962e54cb
2026,Daniele Padelli,it ITA,GK,Udinese,it Serie A,35,1985,3.0,0,0,0,0,0,0,0,,0,0,0,0,0,0,2,1,Matches,cf1c23d8
2027,Simone Pafundi,it ITA,FW,Udinese,it Serie A,15,2006,0.3,0,0,0,0,0,0,1,0.0,1,0,0,0,0,0,0,0,Matches,8daee720
2028,Vincent Pajot,fr FRA,MF,Metz,fr Ligue 1,30,1990,25.7,86,56,35,47,4,20,46,43.5,26,33,6,27,51,137,38,0,Matches,f86ca403
2029,Exequiel Palacios,ar ARG,MF,Leverkusen,de Bundesliga,22,1998,12.2,30,19,12,14,4,15,38,39.5,23,20,1,19,28,58,11,2,Matches,e82adcab
2030,Helibelton Palacios,co COL,DF,Elche,es La Liga,28,1993,21.5,69,38,56,10,3,37,55,67.3,18,21,8,13,18,87,61,0,Matches,ac8b2421
2031,Isaac Palazón Camacho,es ESP,MF,Rayo Vallecano,es La Liga,26,1994,25.4,42,28,20,19,3,18,59,30.5,41,31,3,28,13,55,22,0,Matches,49dbab27
2032,Nicolas Pallois,fr FRA,DF,Nantes,fr Ligue 1,33,1987,27.2,51,33,40,11,0,34,59,57.6,25,40,19,21,53,104,116,1,Matches,779847d6
2033,Cole Palmer,eng ENG,FWMF,Manchester City,eng Premier League,19,2002,1.4,2,1,1,1,0,0,2,0.0,2,3,0,3,1,3,0,0,Matches,dc7f8a28
2034,Erik Palmer-Brown,us USA,DF,Troyes,fr Ligue 1,24,1997,19.3,37,22,29,8,0,20,26,76.9,6,26,18,8,34,71,87,1,Matches,e5c1e0ca
2035,Emerson Palmieri,it ITA,DF,Chelsea,eng Premier League,26,1994,0.1,0,0,0,0,0,0,0,,0,0,0,0,0,0,0,0,Matches,e0bc6fdc
2036,Emerson Palmieri,it ITA,DF,Lyon,fr Ligue 1,26,1994,25.2,46,25,16,22,8,22,34,64.7,12,23,8,15,27,73,66,0,Matches,e0bc6fdc
2037,Martin Palumbo,no NOR,FW,Juventus,it Serie A,19,2002,0.1,0,0,0,0,0,0,1,0.0,1,0,0,0,0,0,0,0,Matches,f8d41a8c
2038,Goran Pandev,mk MKD,FWMF,Genoa,it Serie A,38,1983,9.4,2,0,1,0,1,0,9,0.0,9,3,1,2,2,4,0,0,Matches,d711d04f
2039,Ivor Pandur,hr CRO,GK,Hellas Verona,it Serie A,21,2000,3.0,0,0,0,0,0,0,0,,0,0,0,0,0,0,2,0,Matches,457cb02f
2040,Miloš Pantović,rs SRB,MFFW,Bochum,de Bundesliga,25,1996,17.0,19,10,8,7,4,6,25,24.0,19,26,4,22,18,37,14,0,Matches,5dc15574
2041,Antonios Papadopoulos,de GER,DFMF,Dortmund,de Bundesliga,21,1999,0.2,0,0,0,0,0,0,0,,0,1,0,1,0,0,0,0,Matches,13d23b29
2042,Matondo-Merveille Papela,de GER,MF,Mainz 05,de Bundesliga,20,2001,0.9,3,2,2,1,0,2,3,66.7,1,2,0,2,2,5,0,0,Matches,b4b08774
2043,Lucas Paquetá,br BRA,MFFW,Lyon,fr Ligue 1,23,1997,30.0,68,38,24,26,18,17,51,33.3,34,43,5,38,9,77,22,0,Matches,9b6f7fd5
2044,Rubén Pardo,es ESP,MF,Bordeaux,fr Ligue 1,28,1992,0.1,0,0,0,0,0,0,0,,0,0,0,0,0,0,0,0,Matches,2306bfde
2045,Kevin Paredes,us USA,FWDF,Wolfsburg,de Bundesliga,18,2003,0.2,1,0,0,0,1,0,0,,0,1,0,1,0,1,0,0,Matches,5c50fdbc
2046,Leandro Paredes,ar ARG,MF,Paris S-G,fr Ligue 1,27,1994,9.3,23,13,9,11,3,12,24,50.0,12,10,6,4,10,33,5,2,Matches,dff153a4
2047,Daniel Parejo,es ESP,MF,Villarreal,es La Liga,32,1989,30.0,43,29,15,15,13,20,52,38.5,32,32,7,25,29,72,19,1,Matches,7460ca0d
2048,Fabiano Parisi,it ITA,DF,Empoli,it Serie A,20,2000,16.4,35,19,25,5,5,13,31,41.9,18,30,10,20,22,57,42,0,Matches,0967845b
2049,Raúl Parra,es ESP,DF,Cádiz,es La Liga,21,1999,1.0,2,1,2,0,0,1,3,33.3,2,0,0,0,0,2,5,0,Matches,647d39d2
2050,Thomas Partey,gh GHA,MF,Arsenal,eng Premier League,28,1993,22.5,43,29,22,17,4,18,44,40.9,26,22,4,18,23,66,35,2,Matches,529f49ab
2051,Mario Pašalić,hr CRO,MFFW,Atalanta,it Serie A,26,1995,22.2,27,12,8,13,6,12,30,40.0,18,27,6,21,20,47,14,0,Matches,e599253a
2052,Felix Passlack,de GER,DF,Dortmund,de Bundesliga,23,1998,5.2,13,9,8,4,1,6,12,50.0,6,5,1,4,4,17,7,0,Matches,5c899683
2053,Javier Pastore,ar ARG,MFFW,Elche,es La Liga,32,1989,5.8,7,3,3,2,2,3,12,25.0,9,5,1,4,4,11,2,0,Matches,881ef58c
2054,Patric,es ESP,DF,Lazio,it Serie A,28,1993,18.3,21,15,17,4,0,9,20,45.0,11,22,11,11,12,33,44,2,Matches,f7223718
2055,Rui Patrício,pt POR,GK,Roma,it Serie A,33,1988,38.0,0,0,0,0,0,0,0,,0,1,0,1,0,0,10,3,Matches,79b0d6a0
2056,Paulinho,br BRA,MF,Leverkusen,de Bundesliga,21,2000,13.5,22,13,6,13,3,13,27,48.1,14,14,1,13,6,28,7,0,Matches,53070b63
2057,Gabriel Paulista,br BRA,DF,Valencia,es La Liga,30,1990,17.7,21,12,16,5,0,14,20,70.0,6,18,12,6,39,60,88,0,Matches,b7ca5c51
2058,Benjamin Pavard,fr FRA,DF,Bayern Munich,de Bundesliga,25,1996,23.1,35,20,21,13,1,19,29,65.5,10,28,16,12,36,71,50,1,Matches,45a03961
2059,Strahinja Pavlović,rs SRB,DF,Monaco,fr Ligue 1,20,2001,5.0,23,16,8,13,2,8,12,66.7,4,5,3,2,9,32,15,0,Matches,25146df0
2060,Leonardo Pavoletti,it ITA,FW,Cagliari,it Serie A,32,1988,16.9,10,6,2,5,3,3,9,33.3,6,9,5,4,2,12,12,0,Matches,d37b0350
2061,Dimitri Payet,fr FRA,FWMF,Marseille,fr Ligue 1,34,1987,28.8,16,8,4,10,2,7,31,22.6,24,9,0,9,9,25,3,0,Matches,58ae47b2
2062,Mads Pedersen,dk DEN,MFDF,Augsburg,de Bundesliga,24,1996,15.5,28,21,8,15,5,12,27,44.4,15,13,4,9,15,43,30,0,Matches,582a5247
2063,Alfonso Pedraza,es ESP,DF,Villarreal,es La Liga,25,1996,18.9,34,16,17,12,5,10,28,35.7,18,12,3,9,31,65,32,0,Matches,63f04c6c
2064,Pedri,es ESP,MF,Barcelona,es La Liga,18,2002,9.8,20,12,9,8,3,7,20,35.0,13,13,0,13,5,25,7,1,Matches,0d9b2d31
2065,Pedro,es ESP,FW,Lazio,it Serie A,34,1987,22.6,36,23,8,19,9,16,47,34.0,31,18,2,16,6,42,8,0,Matches,3ca7254a
2066,João Pedro,it ITA,FW,Cagliari,it Serie A,29,1992,36.9,15,12,2,8,5,4,18,22.2,14,23,5,18,8,23,18,1,Matches,81255c03
2067,Pedrosa,es ESP,DF,Espanyol,es La Liga,23,1998,30.2,58,30,38,14,6,26,57,45.6,31,25,7,18,25,83,92,2,Matches,112521d1
2068,Gianluca Pegolo,it ITA,GK,Sassuolo,it Serie A,40,1981,1.0,0,0,0,0,0,0,0,,0,0,0,0,0,0,0,1,Matches,f058ed1f
2069,Peter Pekarík,sk SVK,DF,Hertha BSC,de Bundesliga,34,1986,24.8,45,29,33,11,1,32,46,69.6,14,28,10,18,29,74,58,0,Matches,c18d22f5
2070,Pietro Pellegri,it ITA,FW,Torino,it Serie A,20,2001,2.4,1,1,0,1,0,0,4,0.0,4,0,0,0,0,1,5,0,Matches,a44d3a3c
2071,Pietro Pellegri,it ITA,FW,Milan,it Serie A,20,2001,1.5,2,2,0,1,1,0,1,0.0,1,0,0,0,0,2,1,0,Matches,a44d3a3c
2072,Lorenzo Pellegrini,it ITA,MF,Roma,it Serie A,25,1996,25.4,35,14,10,17,8,16,60,26.7,44,29,1,28,27,62,20,0,Matches,4a5a45c7
2073,Luca Pellegrini,it ITA,DF,Juventus,it Serie A,22,1999,12.3,23,10,13,5,5,12,19,63.2,7,9,1,8,5,28,23,0,Matches,3b61c9ec
2074,Facundo Pellistri,uy URU,MFFW,Alavés,es La Liga,19,2001,7.5,9,5,4,3,2,1,10,10.0,9,13,2,11,6,15,7,0,Matches,ac7e7b1c
2075,Federico Peluso,it ITA,DF,Sassuolo,it Serie A,37,1984,0.1,1,1,0,1,0,1,1,100.0,0,0,0,0,0,1,0,0,Matches,4f2908e5
2076,Timothee Pembele,fr FRA,DF,Bordeaux,fr Ligue 1,18,2002,15.7,20,8,8,10,2,10,29,34.5,19,12,3,9,16,36,24,0,Matches,f8ce97ca
2077,Rubén Peña,es ESP,MFDF,Villarreal,es La Liga,30,1991,1.5,2,0,1,1,0,2,6,33.3,4,1,0,1,5,7,2,0,Matches,1f079188
2078,Philipp Pentke,de GER,GK,Hoffenheim,de Bundesliga,36,1985,1.0,0,0,0,0,0,0,0,,0,0,0,0,0,0,0,0,Matches,c41f7379
2079,Nicolas Pépé,ci CIV,MF,Arsenal,eng Premier League,26,1995,7.7,8,5,3,5,0,3,9,33.3,6,9,1,8,8,16,2,0,Matches,57e3f0c7
2080,Ricardo Pepi,us USA,FWMF,Augsburg,de Bundesliga,18,2003,5.3,4,2,1,3,0,1,8,12.5,7,7,0,7,3,7,8,0,Matches,a2b1ed42
2081,Alberto Perea,es ESP,MF,Cádiz,es La Liga,30,1990,8.6,19,9,7,9,3,6,20,30.0,14,15,1,14,9,28,4,0,Matches,5496cc91
2082,Victor Perea,es ESP,DF,Espanyol,es La Liga,21,2000,0.0,0,0,0,0,0,0,0,,0,0,0,0,0,0,0,0,Matches,b7de5bad
2083,Brayann Pereira,fr FRA,DFMF,Lens,fr Ligue 1,18,2003,0.2,1,1,1,0,0,1,1,100.0,0,0,0,0,0,1,1,0,Matches,5c42e7ce
2084,Danilo Pereira,pt POR,MF,Paris S-G,fr Ligue 1,29,1991,22.6,33,17,10,20,3,14,28,50.0,14,19,10,9,37,70,29,1,Matches,8fd9996f
2085,Mathias Pereira Lage,pt POR,DFMF,Angers,fr Ligue 1,24,1996,11.6,21,7,10,7,4,8,30,26.7,22,18,7,11,21,42,22,0,Matches,8846a40f
2086,Ricardo Pereira,pt POR,DF,Leicester City,eng Premier League,27,1993,11.0,37,20,19,13,5,21,40,52.5,19,13,1,12,17,54,39,0,Matches,75a72a99
2087,Gastón Pereiro,uy URU,FWMF,Cagliari,it Serie A,26,1995,10.8,13,5,7,4,2,5,18,27.8,13,12,1,11,1,14,8,0,Matches,7ec7738e
2088,Luan Peres Petroni,br BRA,DF,Marseille,fr Ligue 1,27,1994,29.8,65,35,33,25,7,36,52,69.2,16,26,12,14,43,108,64,1,Matches,a5549ec1
2089,Dor Peretz,il ISR,MF,Venezia,it Serie A,26,1995,6.5,27,18,8,16,3,13,25,52.0,12,8,4,4,8,35,11,0,Matches,e2a302a8
2090,Roberto Pereyra,ar ARG,MFFW,Udinese,it Serie A,30,1991,19.9,18,12,7,6,5,7,23,30.4,16,26,5,21,12,30,11,0,Matches,75f2c59f
2091,Ayoze Pérez,es ESP,MF,Leicester City,eng Premier League,28,1993,4.9,4,2,0,3,1,0,13,0.0,13,11,1,10,2,6,5,0,Matches,819aa8e7
2092,Carles Pérez,es ESP,MFDF,Roma,it Serie A,23,1998,6.2,8,3,3,1,4,3,12,25.0,9,10,0,10,2,10,2,0,Matches,a8f21b9f
2093,Iñigo Pérez,es ESP,MF,Osasuna,es La Liga,33,1988,3.8,3,2,2,1,0,2,4,50.0,2,1,0,1,0,3,3,0,Matches,bc61cc65
2094,Juan Pérez,es ESP,GK,Osasuna,es La Liga,25,1996,2.0,0,0,0,0,0,0,1,0.0,1,0,0,0,0,0,1,1,Matches,8f29e08b
2095,Kike Pérez,es ESP,MFFW,Elche,es La Liga,24,1997,5.8,8,6,1,3,4,0,10,0.0,10,6,1,5,3,11,4,0,Matches,237a3851
2096,Lucas Pérez,es ESP,FW,Elche,es La Liga,32,1988,14.1,4,1,2,1,1,3,10,30.0,7,2,0,2,3,7,4,0,Matches,a300ac7e
2097,Lucas Pérez,es ESP,FWMF,Cádiz,es La Liga,32,1988,11.8,3,3,2,1,0,0,10,0.0,10,3,1,2,0,3,1,0,Matches,a300ac7e
2098,Nehuén Pérez,ar ARG,DF,Udinese,it Serie A,21,2000,18.8,44,21,21,21,2,16,25,64.0,9,27,9,18,21,65,47,0,Matches,f7c491f1
2099,Mattia Perin,it ITA,GK,Juventus,it Serie A,28,1992,4.5,0,0,0,0,0,0,0,,0,0,0,0,0,0,3,0,Matches,4c62d0c8
2100,Ivan Perišić,hr CRO,DF,Inter,it Serie A,32,1989,31.3,38,22,18,11,9,28,50,56.0,22,39,7,32,47,85,42,0,Matches,6fe90922
2101,Sonny Perkins,eng ENG,FW,West Ham,eng Premier League,17,2004,0.0,,0,,,,,,,,,,,0,,,,Matches,87f12e30
2102,Diego Perotti,ar ARG,MFFW,Salernitana,it Serie A,33,1988,3.2,11,5,7,1,3,4,13,30.8,9,1,0,1,2,13,6,0,Matches,a40d5a0c
2103,Romain Perraud,fr FRA,DF,Southampton,eng Premier League,23,1997,18.0,34,22,18,14,2,16,29,55.2,13,24,6,18,17,51,42,0,Matches,6dfd8f05
2104,Lucas Perrin,fr FRA,DF,Strasbourg,fr Ligue 1,22,1998,27.8,43,32,24,17,2,26,45,57.8,19,28,11,17,42,85,67,0,Matches,49070d66
2105,Mario Perrone,it ITA,DF,Salernitana,it Serie A,18,2003,0.2,0,0,0,0,0,0,0,,0,0,0,0,0,0,0,0,Matches,6cd33e2a
2106,Pavao Pervan,at AUT,GK,Wolfsburg,de Bundesliga,33,1987,6.0,0,0,0,0,0,0,0,,0,0,0,0,0,0,3,0,Matches,c89e8aae
2107,Matteo Pessina,it ITA,MF,Atalanta,it Serie A,24,1997,16.0,27,14,10,11,6,14,33,42.4,19,22,3,19,13,40,7,0,Matches,780e3631
2108,Andrea Petagna,it ITA,FW,Napoli,it Serie A,26,1995,6.5,3,3,0,3,0,1,4,25.0,3,1,0,1,0,3,5,0,Matches,03f946ed
2109,Nils Petersen,de GER,FW,Freiburg,de Bundesliga,32,1988,6.4,5,3,2,3,0,1,13,7.7,12,7,0,7,2,7,17,0,Matches,f93e6e94
2110,Danijel Petković,me MNE,GK,Angers,fr Ligue 1,28,1993,15.0,0,0,0,0,0,0,1,0.0,1,0,0,0,1,1,9,5,Matches,b98cea65
2111,Léo Pétrot,fr FRA,DF,Lorient,fr Ligue 1,24,1997,20.2,31,17,23,8,0,21,29,72.4,8,33,17,16,22,53,86,0,Matches,00638016
2112,Njegoš Petrović,rs SRB,MF,Granada,es La Liga,22,1999,10.2,24,11,4,19,1,8,14,57.1,6,16,4,12,9,33,11,0,Matches,0cb29e91
2113,Jens Petter Hauge,no NOR,MFFW,Eint Frankfurt,de Bundesliga,21,1999,11.6,14,5,6,7,1,7,23,30.4,16,7,0,7,3,17,5,0,Matches,12c35abe
2114,Alex Petxa,es ESP,DFMF,Athletic Club,es La Liga,24,1997,4.6,12,9,4,7,1,4,8,50.0,4,8,2,6,4,16,6,0,Matches,97d08e60
2115,Germán Pezzella,ar ARG,DF,Betis,es La Liga,30,1991,22.1,21,9,16,5,0,16,29,55.2,13,29,18,11,39,60,106,0,Matches,8c725b43
2116,Giuseppe Pezzella,it ITA,DFMF,Atalanta,it Serie A,23,1997,11.9,28,13,15,7,6,8,18,44.4,10,13,5,8,9,37,16,0,Matches,149c5f5d
2117,Immanuel Pherai,nl NED,MF,Dortmund,de Bundesliga,20,2001,0.0,0,0,0,0,0,0,0,,0,0,0,0,0,0,0,0,Matches,f168d9b9
2118,Maximilian Philipp,de GER,MF,Wolfsburg,de Bundesliga,27,1994,10.7,15,11,6,7,2,5,21,23.8,16,12,1,11,4,19,5,0,Matches,061e8e23
2119,Romain Philippoteaux,fr FRA,MF,Brest,fr Ligue 1,33,1988,0.3,1,1,0,1,0,0,0,,0,0,0,0,0,1,0,0,Matches,f98b15f0
2120,Kalvin Phillips,eng ENG,MF,Leeds United,eng Premier League,25,1995,17.7,54,25,24,25,5,24,57,42.1,33,37,9,28,24,78,18,0,Matches,4f565d77
2121,Jaden Philogene Bidace,eng ENG,FW,Aston Villa,eng Premier League,19,2002,0.1,0,0,0,0,0,0,0,,0,0,0,0,0,0,0,0,Matches,19f4d211
2122,Jérôme Phojo,fr FRA,DF,Clermont Foot,fr Ligue 1,28,1993,0.1,0,0,0,0,0,0,0,,0,0,0,0,0,0,1,0,Matches,ff44d058
2123,Krzysztof Piątek,pl POL,FW,Fiorentina,it Serie A,26,1995,8.1,5,4,1,1,3,2,3,66.7,1,6,0,6,2,7,8,0,Matches,17f3620a
2124,Krzysztof Piątek,pl POL,FW,Hertha BSC,de Bundesliga,26,1995,3.9,2,2,0,1,1,0,1,0.0,1,0,0,0,0,2,6,0,Matches,17f3620a
2125,Pablo Piatti,ar ARG,MFFW,Elche,es La Liga,32,1989,3.5,9,4,5,3,1,3,8,37.5,5,5,1,4,2,11,3,0,Matches,48e89655
2126,Cristiano Piccini,it ITA,DF,Valencia,es La Liga,28,1992,3.6,14,8,9,5,0,5,7,71.4,2,3,2,1,1,15,11,0,Matches,32c0491f
2127,Roberto Piccoli,it ITA,FW,Genoa,it Serie A,20,2001,2.4,1,1,0,1,0,0,0,,0,0,0,0,1,2,1,1,Matches,1cadaf34
2128,Roberto Piccoli,it ITA,FW,Atalanta,it Serie A,20,2001,2.2,2,0,0,0,2,0,2,0.0,2,1,0,1,0,2,0,0,Matches,1cadaf34
2129,Jordan Pickford,eng ENG,GK,Everton,eng Premier League,27,1994,35.0,1,1,1,0,0,0,1,0.0,1,1,0,1,1,2,14,1,Matches,4806ec67
2130,Jérémy Pied,fr FRA,DFFW,Lille,fr Ligue 1,32,1989,0.1,0,0,0,0,0,0,0,,0,0,0,0,1,1,0,0,Matches,a634b9d2
2131,Amos Pieper,de GER,DF,Arminia,de Bundesliga,23,1998,26.4,58,29,38,19,1,32,51,62.7,19,37,23,14,50,108,132,1,Matches,526ea7cc
2132,Ronaël Pierre-Gabriel,fr FRA,DF,Brest,fr Ligue 1,23,1998,28.3,79,45,52,21,6,42,73,57.5,31,22,7,15,48,127,74,0,Matches,64ba07c0
2133,Erik Pieters,nl NED,DF,Burnley,eng Premier League,32,1988,8.1,28,15,15,11,2,17,28,60.7,11,18,7,11,10,38,38,0,Matches,1ef37668
2134,Tomás Pina Isla,es ESP,MF,Alavés,es La Liga,33,1987,16.0,28,16,13,11,4,14,29,48.3,15,12,3,9,22,50,23,0,Matches,e54bd0a2
2135,Andrea Pinamonti,it ITA,FW,Empoli,it Serie A,22,1999,31.9,11,6,0,7,4,2,18,11.1,16,24,3,21,7,18,23,0,Matches,08aa9cd1
2136,Orbelín Pineda,mx MEX,MFFW,Celta Vigo,es La Liga,25,1996,1.1,4,1,4,0,0,1,2,50.0,1,0,0,0,0,4,1,0,Matches,411fabd7
2137,Ethan Pinnock,jm JAM,DF,Brentford,eng Premier League,28,1993,29.9,51,35,37,12,2,25,38,65.8,13,30,11,19,44,95,154,1,Matches,e541326e
2138,Yeremi Pino,es ESP,MFFW,Villarreal,es La Liga,18,2002,18.6,32,14,14,8,10,10,24,41.7,14,33,4,29,6,38,12,1,Matches,540ec57b
2139,Carlo Pinsoglio,it ITA,GK,Juventus,it Serie A,31,1990,0.5,0,0,0,0,0,0,0,,0,0,0,0,0,0,0,0,Matches,f6a06749
2140,Riccardo Pinzi,it ITA,FW,Udinese,it Serie A,17,2003,0.0,0,0,0,0,0,0,0,,0,0,0,0,0,0,0,0,Matches,5dafcdce
2141,Gerard Piqué,es ESP,DF,Barcelona,es La Liga,34,1987,23.2,22,12,18,4,0,11,14,78.6,3,19,16,3,34,56,86,1,Matches,adfc9123
2142,Marko Pjaca,hr CRO,MF,Torino,it Serie A,26,1995,12.8,7,4,1,4,2,3,8,37.5,5,10,2,8,4,11,2,0,Matches,2c38b327
2143,Marvin Plattenhardt,de GER,DF,Hertha BSC,de Bundesliga,29,1992,18.2,25,11,18,6,1,15,27,55.6,12,18,3,15,17,42,52,0,Matches,f7aa75bd
2144,Alassane Pléa,fr FRA,MFFW,M'Gladbach,de Bundesliga,28,1993,23.0,18,14,6,9,3,7,20,35.0,13,9,1,8,4,22,10,0,Matches,bc6bd723
2145,Tommaso Pobega,it ITA,MF,Torino,it Serie A,22,1999,24.9,48,30,17,20,11,21,40,52.5,19,32,3,29,25,73,38,0,Matches,55a1cac2
2146,Daniel Podence,pt POR,FWMF,Wolves,eng Premier League,25,1995,16.5,18,11,10,5,3,4,17,23.5,13,8,1,7,10,28,1,0,Matches,7fcc71d8
2147,Suf Podgoreanu,il ISR,MF,Spezia,it Serie A,19,2002,1.3,2,0,1,1,0,1,4,25.0,3,2,0,2,1,3,3,0,Matches,d697a2d0
2148,Paul Pogba,fr FRA,MF,Manchester Utd,eng Premier League,28,1993,15.0,13,9,5,7,1,6,28,21.4,22,11,0,11,13,26,16,0,Matches,867239d3
2149,Joel Pohjanpalo,fi FIN,FW,Leverkusen,de Bundesliga,26,1994,0.1,0,0,0,0,0,0,0,,0,0,0,0,0,0,0,0,Matches,ea003d07
2150,Matteo Politano,it ITA,MFFW,Napoli,it Serie A,27,1993,18.3,24,12,8,11,5,15,54,27.8,39,11,2,9,13,37,5,0,Matches,5e861944
2151,Julian Pollersbeck,de GER,GK,Lyon,fr Ligue 1,26,1994,4.8,0,0,0,0,0,0,0,,0,0,0,0,1,1,1,0,Matches,d6f6ce93
2152,Sebastian Polter,de GER,FW,Bochum,de Bundesliga,30,1991,26.0,9,3,1,4,4,2,11,18.2,9,15,5,10,2,11,24,0,Matches,3745e8bd
2153,Ezequiel Ponce,ar ARG,FW,Elche,es La Liga,24,1997,7.4,5,4,1,3,1,3,10,30.0,7,5,0,5,1,6,7,0,Matches,ccbbe661
2154,Marin Pongračić,hr CRO,DF,Dortmund,de Bundesliga,23,1997,9.2,17,10,13,4,0,6,10,60.0,4,11,5,6,17,34,32,2,Matches,2a6cd437
2155,Pere Pons,es ESP,MF,Alavés,es La Liga,28,1993,15.2,26,18,4,20,2,7,21,33.3,14,10,1,9,6,32,11,0,Matches,29b61deb
2156,Nick Pope,eng ENG,GK,Burnley,eng Premier League,29,1992,36.0,0,0,0,0,0,0,2,0.0,2,0,0,0,2,2,30,3,Matches,4b40d9ca
2157,Manolo Portanova,it ITA,MF,Genoa,it Serie A,21,2000,14.7,46,28,9,26,11,14,34,41.2,20,26,2,24,17,63,22,0,Matches,c8c0dccd
2158,Portu,es ESP,MFFW,Real Sociedad,es La Liga,29,1992,17.7,16,7,2,6,8,3,19,15.8,16,21,3,18,7,23,8,0,Matches,1bda5842
2159,Stefan Posch,at AUT,DF,Hoffenheim,de Bundesliga,24,1997,24.4,48,30,20,26,2,22,39,56.4,17,43,18,25,28,76,71,2,Matches,7f609bfc
2160,Sergio Postigo,es ESP,DF,Levante,es La Liga,32,1988,9.4,11,7,8,2,1,4,8,50.0,4,7,5,2,7,18,45,1,Matches,474ecac8
2161,Yussuf Poulsen,dk DEN,FWMF,RB Leipzig,de Bundesliga,27,1994,12.0,13,4,3,6,4,3,13,23.1,10,13,0,13,3,16,9,0,Matches,d2416c2e
2162,Gaëtan Poussin,fr FRA,GK,Bordeaux,fr Ligue 1,22,1999,13.0,1,1,1,0,0,1,1,100.0,0,0,0,0,0,1,15,1,Matches,c252c705
2163,Darío Poveda,es ESP,FWMF,Getafe,es La Liga,24,1997,4.2,2,0,1,0,1,0,5,0.0,5,7,1,6,1,3,1,0,Matches,cbdf7d5c
2164,José Pozo,es ESP,MFDF,Rayo Vallecano,es La Liga,25,1996,0.8,2,2,0,2,0,2,3,66.7,1,1,0,1,0,2,1,0,Matches,fc8b614b
2165,Dennis Praet,be BEL,MF,Torino,it Serie A,27,1994,17.1,19,10,6,8,5,8,22,36.4,14,12,1,11,3,22,4,0,Matches,86695068
2166,Mateusz Praszelik,pl POL,MF,Hellas Verona,it Serie A,20,2000,0.3,0,0,0,0,0,0,0,,0,0,0,0,0,0,0,0,Matches,ec6773f5
2167,Abdón Prats,es ESP,FW,Mallorca,es La Liga,28,1992,7.1,2,2,1,0,1,1,5,20.0,4,5,0,5,1,3,6,0,Matches,d1b060e2
2168,Sanjin Prcić,ba BIH,MF,Strasbourg,fr Ligue 1,27,1993,24.3,47,28,14,27,6,14,29,48.3,15,18,3,15,47,94,19,0,Matches,51c30111
2169,Nicolas de Préville,fr FRA,FWMF,Metz,fr Ligue 1,30,1991,21.9,17,8,7,8,2,3,19,15.8,16,12,4,8,5,22,11,0,Matches,b0547a87
2170,Isaac Price,nir NIR,MF,Everton,eng Premier League,17,2003,0.2,0,0,0,0,0,0,0,,0,1,0,1,0,0,0,0,Matches,b9403c99
2171,Manuel Prietl,at AUT,MF,Arminia,de Bundesliga,29,1991,23.6,59,26,23,31,5,23,60,38.3,37,28,3,25,39,98,33,0,Matches,901c0f97
2172,Alejandro Primo,es ESP,GK,Levante,es La Liga,17,2004,1.0,0,0,0,0,0,0,0,,0,0,0,0,0,0,0,0,Matches,f38284bb
2173,Grischa Prömel,de GER,MF,Union Berlin,de Bundesliga,26,1995,26.9,36,22,14,17,5,22,52,42.3,30,18,3,15,23,59,22,0,Matches,924f9191
2174,Nick Proschwitz,de GER,FW,Hoffenheim,de Bundesliga,34,1986,0.3,0,0,0,0,0,0,0,,0,0,0,0,0,0,0,0,Matches,9cf4fd68
2175,Ivan Provedel,it ITA,GK,Spezia,it Serie A,27,1994,30.7,0,0,0,0,0,0,1,0.0,1,0,0,0,2,2,10,2,Matches,277da414
2176,Javi Puado,es ESP,MFFW,Espanyol,es La Liga,23,1998,24.9,24,14,18,5,1,12,37,32.4,25,18,2,16,11,35,24,0,Matches,2683eda7
2177,Pubill,es ESP,DFMF,Levante,es La Liga,18,2003,5.7,12,6,10,2,0,4,8,50.0,4,7,2,5,4,16,8,2,Matches,365113c0
2178,Antonio Puertas,es ESP,MFFW,Granada,es La Liga,29,1992,25.1,34,20,18,12,4,17,44,38.6,27,33,3,30,11,45,36,0,Matches,c77a8043
2179,Riqui Puig,es ESP,MF,Barcelona,es La Liga,21,1999,5.4,6,3,2,4,0,2,14,14.3,12,5,0,5,3,9,0,0,Matches,f090a37a
2180,Teemu Pukki,fi FIN,FW,Norwich City,eng Premier League,31,1990,36.1,23,11,2,14,7,6,29,20.7,23,21,1,20,4,27,3,0,Matches,0745b37d
2181,Erick Pulgar,cl CHI,MF,Fiorentina,it Serie A,27,1994,3.8,6,6,4,2,0,4,9,44.4,5,5,1,4,5,11,2,1,Matches,4611e028
2182,Christian Pulisic,us USA,MFFW,Chelsea,eng Premier League,22,1998,14.3,10,7,6,3,1,3,17,17.6,14,12,0,12,5,15,10,0,Matches,1bf33a9a
2183,Afimico Pululu,fr FRA,FWMF,Greuther Fürth,de Bundesliga,22,1999,0.8,1,0,1,0,0,1,2,50.0,1,1,0,1,0,1,0,0,Matches,32c016f8
2184,Ignacio Pussetto,ar ARG,FWMF,Udinese,it Serie A,25,1995,13.4,17,9,2,9,6,2,10,20.0,8,18,2,16,4,21,13,0,Matches,62437b4f
2185,Niklas Pyyhtiä,fi FIN,MF,Bologna,it Serie A,17,2003,0.2,0,0,0,0,0,0,1,0.0,1,0,0,0,0,0,0,0,Matches,88f53b75
2186,Przemysław Płacheta,pl POL,MFFW,Norwich City,eng Premier League,23,1998,5.6,4,3,3,1,0,2,7,28.6,5,3,1,2,2,6,5,1,Matches,3c33f9d9
2187,Yacine Qasmi,ma MAR,FW,Rayo Vallecano,es La Liga,30,1991,0.0,0,0,0,0,0,0,0,,0,0,0,0,0,0,0,0,Matches,3b3cbebb
2188,Fabio Quagliarella,it ITA,FW,Sampdoria,it Serie A,38,1983,18.5,6,2,2,2,2,2,15,13.3,13,14,1,13,3,9,12,0,Matches,ee4f2f3b
2189,Quini,es ESP,DF,Granada,es La Liga,31,1989,25.6,73,34,48,21,4,42,79,53.2,37,28,10,18,36,109,62,0,Matches,7a538238
2190,Dani Raba,es ESP,MFFW,Villarreal,es La Liga,25,1995,1.0,1,0,0,1,0,1,2,50.0,1,2,0,2,0,1,2,0,Matches,ea6a7ab4
2191,Dani Raba,es ESP,MF,Granada,es La Liga,25,1995,0.3,2,2,1,0,1,2,3,66.7,1,0,0,0,1,3,0,0,Matches,ea6a7ab4
2192,Adrien Rabiot,fr FRA,MF,Juventus,it Serie A,26,1995,25.4,64,43,32,24,8,15,34,44.1,19,34,8,26,20,84,41,1,Matches,8794e251
2193,Uroš Račić,rs SRB,MF,Valencia,es La Liga,23,1998,13.4,32,18,9,19,4,12,33,36.4,21,16,6,10,16,48,21,0,Matches,faed84db
2194,Nemanja Radoja,rs SRB,MF,Levante,es La Liga,28,1993,13.5,25,8,9,13,3,8,20,40.0,12,16,9,7,22,47,16,2,Matches,b5dd3469
2195,Nemanja Radonjić,rs SRB,FW,Marseille,fr Ligue 1,25,1996,0.2,0,0,0,0,0,0,0,,0,0,0,0,0,0,0,0,Matches,0630eb63
2196,Ivan Radovanović,rs SRB,DFMF,Salernitana,it Serie A,32,1988,11.7,11,7,8,3,0,7,19,36.8,12,14,7,7,7,18,29,0,Matches,023937a9
2197,Ionuț Radu,ro ROU,GK,Inter,it Serie A,24,1997,1.0,0,0,0,0,0,0,0,,0,0,0,0,0,0,0,1,Matches,67f649be
2198,Ștefan Radu,ro ROU,DF,Lazio,it Serie A,34,1986,6.2,9,6,3,6,0,5,9,55.6,4,7,2,5,5,14,15,0,Matches,53de807a
2199,Boris Radunović,rs SRB,GK,Cagliari,it Serie A,25,1996,3.0,0,0,0,0,0,0,0,,0,0,0,0,0,0,0,0,Matches,0dfce079
2200,Sidney Raebiger,de GER,MF,RB Leipzig,de Bundesliga,16,2005,0.0,0,0,0,0,0,0,0,,0,0,0,0,0,0,0,0,Matches,a8090a41
2201,Rafinha,br BRA,MF,Real Sociedad,es La Liga,28,1993,11.7,43,27,17,20,6,16,28,57.1,12,21,2,19,12,55,4,0,Matches,0c2ac3cb
2202,Rafinha,br BRA,FWMF,Paris S-G,fr Ligue 1,28,1993,2.4,14,8,3,9,2,7,11,63.6,4,3,0,3,4,18,0,0,Matches,0c2ac3cb
2203,Antonio Raillo,es ESP,DF,Mallorca,es La Liga,29,1991,17.0,16,7,10,4,2,5,6,83.3,1,17,14,3,18,34,81,0,Matches,b857bd29
2204,Antonio Raimondo,it ITA,FW,Bologna,it Serie A,17,2004,0.8,0,0,0,0,0,0,1,0.0,1,1,0,1,0,0,1,0,Matches,ce1a6c7e
2205,Predrag Rajković,rs SRB,GK,Reims,fr Ligue 1,25,1995,38.0,2,2,2,0,0,2,3,66.7,1,1,0,1,1,3,21,1,Matches,58ad9383
2206,Jesuran Rak Sakyi,eng ENG,FWMF,Crystal Palace,eng Premier League,18,2002,0.9,0,0,0,0,0,0,1,0.0,1,3,0,3,1,1,0,0,Matches,45685411
2207,Ivan Rakitić,hr CRO,MF,Sevilla,es La Liga,33,1988,24.2,40,22,12,23,5,13,40,32.5,27,31,8,23,23,63,35,0,Matches,89f951b5
2208,Diant Ramaj,de GER,GK,Eint Frankfurt,de Bundesliga,19,2001,1.0,0,0,0,0,0,0,0,,0,0,0,0,0,0,3,0,Matches,b90c4a43
2209,Jonás Ramalho,es ESP,DF,Osasuna,es La Liga,28,1993,2.7,4,2,2,2,0,2,3,66.7,1,4,1,3,3,7,9,0,Matches,be3a0121
2210,Adil Rami,fr FRA,DF,Troyes,fr Ligue 1,35,1985,13.0,10,9,6,4,0,7,8,87.5,1,17,9,8,16,26,43,0,Matches,8dbff17c
2211,Sandro Ramírez,es ESP,FW,Getafe,es La Liga,26,1995,16.2,7,3,1,3,3,1,12,8.3,11,14,3,11,2,9,3,0,Matches,833fb62e
2212,Guilherme Ramos,pt POR,DF,Arminia,de Bundesliga,23,1997,10.1,25,15,17,8,0,12,19,63.2,7,21,8,13,27,52,51,0,Matches,df9c3473
2213,Sergio Ramos,es ESP,DF,Paris S-G,fr Ligue 1,35,1986,8.9,12,5,6,6,0,8,15,53.3,7,4,2,2,8,20,27,0,Matches,08511d65
2214,Aaron Ramsdale,eng ENG,GK,Arsenal,eng Premier League,23,1998,34.0,2,1,2,0,0,1,2,50.0,1,0,0,0,0,2,26,3,Matches,466fb2c5
2215,Aaron Ramsey,wls WAL,MF,Juventus,it Serie A,30,1990,1.1,0,0,0,0,0,0,0,,0,0,0,0,1,1,0,0,Matches,ef619b0b
2216,Jacob Ramsey,eng ENG,MF,Aston Villa,eng Premier League,20,2001,27.4,67,44,31,28,8,30,69,43.5,39,36,7,29,24,91,28,0,Matches,1544f145
2217,Luca Ranieri,it ITA,DF,Salernitana,it Serie A,22,1999,23.4,38,21,23,11,4,19,33,57.6,14,18,8,10,22,60,67,0,Matches,8c63fae5
2218,Andrea Ranocchia,it ITA,DF,Inter,it Serie A,33,1988,3.8,8,4,5,1,2,1,3,33.3,2,4,3,1,4,12,16,0,Matches,539230cf
2219,Raphinha,br BRA,MFFW,Leeds United,eng Premier League,24,1996,32.4,51,29,25,14,12,22,71,31.0,49,43,0,43,29,80,28,1,Matches,3423f250
2220,Tobias Raschl,de GER,MF,Greuther Fürth,de Bundesliga,21,2000,6.6,12,9,4,8,0,5,7,71.4,2,10,1,9,3,15,1,0,Matches,bd992863
2221,Elba Rashani,xk KVX,MFFW,Clermont Foot,fr Ligue 1,28,1993,19.5,40,21,15,21,4,17,55,30.9,38,34,3,31,11,51,20,0,Matches,25749008
2222,Marcus Rashford,eng ENG,MFFW,Manchester Utd,eng Premier League,23,1997,13.7,6,5,1,4,1,2,13,15.4,11,10,1,9,5,11,5,1,Matches,a1d5bd30
2223,Milot Rashica,xk KVX,MFFW,Norwich City,eng Premier League,25,1996,24.8,31,19,12,12,7,11,30,36.7,19,22,3,19,15,46,23,0,Matches,6c6a3300
2224,Giacomo Raspadori,it ITA,MFFW,Sassuolo,it Serie A,21,2000,30.4,29,18,5,15,9,11,38,28.9,27,29,3,26,9,38,11,0,Matches,6e058f06
2225,Raúl,es ESP,MFDF,Betis,es La Liga,20,2000,0.0,0,0,0,0,0,0,0,,0,0,0,0,0,0,0,0,Matches,18f0a9f0
2226,David Raum,de GER,DFFW,Hoffenheim,de Bundesliga,23,1998,30.6,52,29,30,10,12,30,64,46.9,34,38,5,33,27,79,39,1,Matches,7d450ed3
2227,Nicola Ravaglia,it ITA,GK,Sampdoria,it Serie A,32,1988,0.1,0,0,0,0,0,0,0,,0,0,0,0,0,0,0,0,Matches,d7a35008
2228,David Raya,es ESP,GK,Brentford,eng Premier League,25,1995,24.0,0,0,0,0,0,0,0,,0,1,0,1,0,0,10,1,Matches,98ea5115
2229,Ante Rebić,hr CRO,MFFW,Milan,it Serie A,27,1993,9.9,14,8,3,6,5,7,20,35.0,13,14,0,14,3,17,3,1,Matches,536cebe5
2230,Arkadiusz Reca,pl POL,DF,Spezia,it Serie A,26,1995,19.7,31,19,21,3,7,20,30,66.7,10,20,7,13,32,63,47,2,Matches,6213fd82
2231,Lluís Recasens,es ESP,DF,Espanyol,es La Liga,19,2002,0.5,2,0,2,0,0,1,1,100.0,0,0,0,0,2,4,2,0,Matches,c31ea173
2232,Nathan Redmond,eng ENG,MFFW,Southampton,eng Premier League,27,1994,20.4,22,14,9,9,4,7,30,23.3,23,21,2,19,8,30,16,0,Matches,ab651565
2233,Sergio Reguilón,es ESP,DFMF,Tottenham,eng Premier League,24,1996,21.3,40,24,15,18,7,22,43,51.2,21,20,8,12,31,71,45,1,Matches,3353737a
2234,Manolo Reina,es ESP,GK,Mallorca,es La Liga,36,1985,21.0,0,0,0,0,0,0,0,,0,0,0,0,1,1,6,2,Matches,605eb473
2235,Pepe Reina,es ESP,GK,Lazio,it Serie A,38,1982,15.0,0,0,0,0,0,0,1,0.0,1,0,0,0,0,0,1,1,Matches,e358587b
2236,Jeff Reine-Adélaïde,fr FRA,MFDF,Lyon,fr Ligue 1,23,1998,2.2,5,3,4,1,0,4,5,80.0,1,2,0,2,0,5,0,1,Matches,d504b3e1
2237,Reinier,br BRA,MFFW,Dortmund,de Bundesliga,19,2002,1.8,5,3,4,0,1,1,1,100.0,0,3,0,3,0,5,0,0,Matches,6b21b7b5
2238,Karim Rekik,nl NED,DF,Sevilla,es La Liga,26,1994,12.2,11,8,4,6,1,2,9,22.2,7,11,6,5,9,20,19,0,Matches,3376a776
2239,Álex Remiro,es ESP,GK,Real Sociedad,es La Liga,26,1995,35.0,0,0,0,0,0,0,0,,0,0,0,0,1,1,24,2,Matches,374ee424
2240,Panagiotis Retsos,gr GRE,DF,Hellas Verona,it Serie A,22,1998,0.6,0,0,0,0,0,0,2,0.0,2,0,0,0,2,2,3,0,Matches,4bd00a50
2241,Panagiotis Retsos,gr GRE,DFMF,Leverkusen,de Bundesliga,22,1998,0.4,0,0,0,0,0,0,0,,0,0,0,0,1,1,0,1,Matches,4bd00a50
2242,Marco Reus,de GER,MFFW,Dortmund,de Bundesliga,32,1989,27.8,45,30,13,21,11,16,42,38.1,26,23,6,17,12,57,41,1,Matches,36a3ff67
2243,Elvis Rexhbeçaj,de GER,MF,Bochum,de Bundesliga,23,1997,28.2,43,20,17,21,5,19,42,45.2,23,41,6,35,27,70,15,0,Matches,1ae836b1
2244,Gio Reyna,us USA,MF,Dortmund,de Bundesliga,18,2002,4.9,7,4,2,4,1,3,9,33.3,6,6,0,6,1,8,3,0,Matches,7fa4e703
2245,Bryan Reynolds,us USA,DF,Roma,it Serie A,20,2001,0.0,0,0,0,0,0,0,1,0.0,1,0,0,0,0,0,1,0,Matches,2306bf5c
2246,Nico Ribaudo,es ESP,MF,Espanyol,es La Liga,20,2001,12.4,15,6,9,5,1,11,34,32.4,23,14,2,12,7,22,3,0,Matches,ce8039aa
2247,Tiago Ribeiro,pt POR,MF,Monaco,fr Ligue 1,19,2002,0.0,0,0,0,0,0,0,0,,0,0,0,0,0,0,0,0,Matches,507d7569
2248,Franck Ribéry,fr FRA,MFFW,Salernitana,it Serie A,38,1983,15.8,17,10,6,6,5,8,13,61.5,5,12,0,12,3,20,1,0,Matches,f61c7c4e
2249,Samuele Ricci,it ITA,MF,Torino,it Serie A,19,2001,8.0,8,4,4,2,2,2,5,40.0,3,7,1,6,14,22,9,0,Matches,9823be92
2250,Samuele Ricci,it ITA,MF,Empoli,it Serie A,19,2001,17.0,33,19,17,13,3,20,34,58.8,14,24,5,19,31,64,18,0,Matches,9823be92
2251,Declan Rice,eng ENG,MF,West Ham,eng Premier League,22,1999,35.3,80,42,45,32,3,38,71,53.5,33,45,21,24,63,143,52,1,Matches,1c7012b8
2252,Chris Richards,us USA,DF,Hoffenheim,de Bundesliga,21,2000,14.5,26,15,10,15,1,11,18,61.1,7,21,9,12,22,48,50,1,Matches,0a3d6d2b
2253,Chris Richards,us USA,DF,Bayern Munich,de Bundesliga,21,2000,0.0,0,0,0,0,0,0,0,,0,1,0,1,0,0,0,0,Matches,0a3d6d2b
2254,Omar Richards,eng ENG,DF,Bayern Munich,de Bundesliga,23,1998,4.9,19,12,11,5,3,11,16,68.8,5,7,1,6,4,23,7,0,Matches,f9b1b7bf
2255,Taylor Richards,eng ENG,MF,Brighton,eng Premier League,20,2000,0.3,1,0,0,1,0,1,2,50.0,1,0,0,0,0,1,0,0,Matches,e0243d23
2256,Richarlison,br BRA,FWMF,Everton,eng Premier League,24,1997,28.0,40,23,18,15,7,15,31,48.4,16,42,4,38,12,52,34,0,Matches,fa031b34
2257,Marco Richter,de GER,MFFW,Hertha BSC,de Bundesliga,23,1997,18.9,30,16,14,10,6,13,36,36.1,23,30,4,26,16,46,24,0,Matches,f972644c
2258,Diego Rico,es ESP,DF,Real Sociedad,es La Liga,28,1993,18.3,41,20,19,17,5,22,45,48.9,23,29,4,25,30,71,54,0,Matches,d9ba39fc
2259,Sergio Rico,es ESP,GK,Mallorca,es La Liga,27,1993,14.0,0,0,0,0,0,0,0,,0,0,0,0,0,0,5,2,Matches,5f0241b2
2260,Sergio Rico,es ESP,GK,Paris S-G,fr Ligue 1,27,1993,0.3,0,0,0,0,0,0,0,,0,0,0,0,0,0,1,0,Matches,5f0241b2
2261,Jaïro Riedewald,nl NED,MF,Crystal Palace,eng Premier League,24,1996,1.3,1,1,0,1,0,1,2,50.0,1,1,0,1,1,2,2,0,Matches,7a1f2c08
2262,Manuel Riemann,de GER,GK,Bochum,de Bundesliga,32,1988,31.0,1,0,1,0,0,1,4,25.0,3,0,0,0,1,2,12,3,Matches,9f941969
2263,Tomás Rincón,ve VEN,MF,Torino,it Serie A,33,1988,1.8,2,2,2,0,0,0,3,0.0,3,3,1,2,2,4,4,0,Matches,f1cfc209
2264,Tomás Rincón,ve VEN,MF,Sampdoria,it Serie A,33,1988,13.0,22,13,9,10,3,13,34,38.2,21,15,2,13,18,40,11,0,Matches,f1cfc209
2265,Luis Rioja,es ESP,MFFW,Alavés,es La Liga,27,1993,34.6,28,15,11,10,7,14,58,24.1,44,22,1,21,25,53,20,0,Matches,eb3dd471
2266,Renaud Ripart,fr FRA,MFFW,Troyes,fr Ligue 1,28,1993,21.0,38,21,18,15,5,18,50,36.0,32,21,1,20,19,57,21,1,Matches,beae3a73
2267,Mihailo Ristić,rs SRB,DF,Montpellier,fr Ligue 1,25,1995,20.0,44,32,26,16,2,25,43,58.1,18,16,6,10,17,61,48,0,Matches,ea0aa7e0
2268,Matt Ritchie,sct SCO,DF,Newcastle Utd,eng Premier League,31,1989,14.9,22,15,10,10,2,10,27,37.0,17,10,2,8,13,35,26,0,Matches,71ef519e
2269,Maxence Rivera,fr FRA,FW,Saint-Étienne,fr Ligue 1,19,2002,0.1,0,0,0,0,0,0,0,,0,0,0,0,0,0,0,0,Matches,46a7b605
2270,Rober,es ESP,DF,Levante,es La Liga,26,1995,22.3,36,20,27,7,2,23,39,59.0,16,25,15,10,30,66,90,1,Matches,c00097d2
2271,Sergi Roberto,es ESP,MFDF,Barcelona,es La Liga,29,1992,4.4,5,1,2,3,0,3,5,60.0,2,2,0,2,4,9,6,0,Matches,335fa267
2272,Connor Roberts,wls WAL,DF,Burnley,eng Premier League,25,1995,18.8,20,13,10,7,3,10,15,66.7,5,25,5,20,22,42,62,1,Matches,24fae784
2273,Patrick Roberts,eng ENG,MF,Troyes,fr Ligue 1,24,1997,0.2,0,0,0,0,0,0,0,,0,0,0,0,0,0,0,0,Matches,59d93937
2274,Tyler Roberts,wls WAL,MFFW,Leeds United,eng Premier League,22,1999,11.0,16,7,6,7,3,9,16,56.3,7,11,1,10,5,21,11,0,Matches,6c17e046
2275,Andrew Robertson,sct SCO,DF,Liverpool,eng Premier League,27,1994,28.2,36,21,16,15,5,20,35,57.1,15,24,3,21,23,59,61,0,Matches,2e4f5f03
2276,Marc Roca,es ESP,MF,Bayern Munich,de Bundesliga,24,1996,4.2,9,7,2,4,3,2,8,25.0,6,6,0,6,6,15,4,0,Matches,da27e268
2277,Rubén Rochina,es ESP,MFFW,Granada,es La Liga,30,1991,8.3,21,13,7,8,6,8,28,28.6,20,11,1,10,6,27,5,1,Matches,ecd8c01e
2278,Cimo Röcker,de GER,DF,Hertha BSC,de Bundesliga,27,1994,0.2,0,0,0,0,0,0,0,,0,0,0,0,2,2,0,0,Matches,611b1aae
2279,Enzo Roco,cl CHI,DF,Elche,es La Liga,28,1992,28.4,36,20,24,11,1,15,24,62.5,9,38,27,11,28,64,110,3,Matches,37f827ec
2280,Stian Rode Gregersen,no NOR,DF,Bordeaux,fr Ligue 1,26,1995,21.7,39,26,23,12,4,18,33,54.5,15,26,16,10,38,77,103,2,Matches,5f011e05
2281,Sebastian Rode,de GER,MF,Eint Frankfurt,de Bundesliga,30,1990,8.4,15,7,5,8,2,5,17,29.4,12,11,1,10,13,28,8,0,Matches,e12b0b5b
2282,Joe Rodon,wls WAL,DF,Tottenham,eng Premier League,23,1997,1.0,0,0,0,0,0,0,0,,0,2,1,1,0,0,7,0,Matches,8d62d31a
2283,Rodri,es ESP,MF,Manchester City,eng Premier League,25,1996,32.0,72,43,24,38,10,32,59,54.2,27,28,5,23,28,100,45,0,Matches,6434f10d
2284,Rodrigo,es ESP,MFFW,Leeds United,eng Premier League,30,1991,25.2,20,9,7,6,7,4,32,12.5,28,12,0,12,11,31,27,1,Matches,1fb1c435
2285,Rodrigo,es ESP,MF,Betis,es La Liga,21,2000,9.8,10,7,4,5,1,5,22,22.7,17,11,0,11,3,13,4,0,Matches,85bed4ee
2286,Gerson Rodrigues,lu LUX,FWMF,Troyes,fr Ligue 1,26,1995,9.4,12,9,2,6,4,1,17,5.9,16,8,1,7,0,12,2,0,Matches,3814b753
2287,Kévin Rodrigues,pt POR,DFMF,Rayo Vallecano,es La Liga,27,1994,4.8,15,11,8,7,0,6,10,60.0,4,10,1,9,7,22,6,0,Matches,f1bed920
2288,Ángel Rodríguez,es ESP,FWMF,Mallorca,es La Liga,34,1987,17.2,15,9,6,7,2,4,21,19.0,17,15,1,14,3,18,13,0,Matches,8cfc2f69
2289,Óscar Rodríguez Arnaiz,es ESP,MFFW,Getafe,es La Liga,23,1998,10.5,16,11,6,8,2,4,12,33.3,8,7,1,6,11,27,6,0,Matches,19709006
2290,Óscar Rodríguez Arnaiz,es ESP,MFFW,Sevilla,es La Liga,23,1998,4.6,4,3,1,3,0,2,3,66.7,1,2,0,2,5,9,7,1,Matches,19709006
2291,Dani Rodríguez,es ESP,MF,Mallorca,es La Liga,33,1988,31.5,53,31,20,24,9,15,46,32.6,31,28,3,25,20,73,27,0,Matches,70f8e0bd
2292,Guido Rodríguez,ar ARG,MF,Betis,es La Liga,27,1994,28.1,97,53,46,45,6,54,98,55.1,44,55,12,43,31,128,56,0,Matches,34e393f2
2293,Jay Rodriguez,eng ENG,FW,Burnley,eng Premier League,32,1989,15.4,20,12,8,8,4,4,14,28.6,10,19,1,18,4,24,12,0,Matches,4ab53cdb
2294,Ricardo Rodríguez,ch SUI,DF,Torino,it Serie A,28,1992,27.5,36,21,11,23,2,18,33,54.5,15,22,8,14,41,77,48,1,Matches,7f78ad23
2295,Rodrygo,br BRA,FWMF,Real Madrid,es La Liga,20,2001,16.9,18,14,7,4,7,3,18,16.7,15,21,0,21,11,29,3,0,Matches,8f5e92a6
2296,Mads Roerslev,dk DEN,DF,Brentford,eng Premier League,22,1999,13.8,23,12,19,2,2,14,32,43.8,18,14,5,9,16,39,29,0,Matches,57c94db2
2297,Marko Rog,hr CRO,MF,Cagliari,it Serie A,26,1995,3.5,5,3,1,2,2,1,8,12.5,7,6,1,5,1,6,3,0,Matches,b6b2b820
2298,Rogério,br BRA,DF,Sassuolo,it Serie A,23,1998,19.2,21,13,12,5,4,15,22,68.2,7,20,8,12,18,39,42,1,Matches,10e7f486
2299,Alessio Romagnoli,it ITA,DF,Milan,it Serie A,26,1995,15.7,24,14,14,10,0,14,18,77.8,4,21,12,9,19,43,45,0,Matches,3ead85f9
2300,Simone Romagnoli,it ITA,DF,Empoli,it Serie A,31,1990,16.6,28,12,14,12,2,15,20,75.0,5,34,28,6,9,37,86,0,Matches,09899de8
2301,Leonardo Román,es ESP,GK,Mallorca,es La Liga,21,2000,2.0,0,0,0,0,0,0,0,,0,0,0,0,0,0,2,0,Matches,924ff27e
2302,Cristian Romero,ar ARG,DF,Tottenham,eng Premier League,23,1998,20.5,62,39,39,21,2,22,34,64.7,12,46,21,25,33,95,74,1,Matches,a3d94a58
2303,Iván Romero,es ESP,FW,Sevilla,es La Liga,20,2001,2.0,2,2,0,2,0,0,0,,0,1,0,1,2,4,0,0,Matches,2fbe6af0
2304,Luka Romero,ar ARG,FW,Lazio,it Serie A,16,2004,0.9,2,1,0,1,1,0,2,0.0,2,0,0,0,1,3,0,0,Matches,ca6edaa0
2305,Sergio Romero,ar ARG,GK,Venezia,it Serie A,34,1987,16.0,2,2,2,0,0,2,2,100.0,0,0,0,0,1,3,10,0,Matches,1e26e376
2306,Oriol Romeu,es ESP,MF,Southampton,eng Premier League,29,1991,32.1,77,39,25,45,7,28,73,38.4,45,39,8,31,51,128,43,0,Matches,4b511457
2307,Cristiano Ronaldo,pt POR,FW,Manchester Utd,eng Premier League,36,1985,27.3,8,6,1,5,2,2,6,33.3,4,8,0,8,2,10,29,0,Matches,dea698d9
2308,Cristiano Ronaldo,pt POR,FW,Juventus,it Serie A,36,1985,0.3,1,0,0,1,0,1,1,100.0,0,0,0,0,0,1,0,0,Matches,dea698d9
2309,Salomón Rondón,ve VEN,FW,Everton,eng Premier League,31,1989,8.8,6,1,1,2,3,4,14,28.6,10,5,0,5,0,6,10,0,Matches,b318a643
2310,Valentin Rongier,fr FRA,MFDF,Marseille,fr Ligue 1,26,1994,24.4,77,51,36,36,5,28,60,46.7,32,26,5,21,33,110,14,0,Matches,ed45c4a5
2311,Marten de Roon,nl NED,MFDF,Atalanta,it Serie A,30,1991,28.3,69,42,33,29,7,34,62,54.8,28,36,2,34,45,114,41,0,Matches,2a1beb34
2312,Unai Ropero,es ESP,MF,Alavés,es La Liga,19,2001,0.1,0,0,0,0,0,0,0,,0,0,0,0,1,1,0,0,Matches,7868c973
2313,Pablo Rosario,nl NED,MF,Nice,fr Ligue 1,24,1997,30.3,59,37,18,32,9,26,66,39.4,40,33,7,26,38,97,43,0,Matches,1a6b7ea4
2314,Romario Rösch,de GER,MF,Mainz 05,de Bundesliga,22,1999,0.0,0,0,0,0,0,0,0,,0,0,0,0,0,0,0,0,Matches,87ebfdb8
2315,Danny Rose,eng ENG,DF,Watford,eng Premier League,31,1990,7.7,16,10,11,4,1,10,24,41.7,14,8,5,3,14,30,11,1,Matches,89d10e53
2316,Francesco Rossi,it ITA,GK,Atalanta,it Serie A,30,1991,0.4,0,0,0,0,0,0,0,,0,0,0,0,0,0,0,0,Matches,7b5f516f
2317,Tom Rothe,de GER,DF,Dortmund,de Bundesliga,16,2004,1.0,4,3,2,2,0,3,6,50.0,3,2,0,2,2,6,3,0,Matches,90c1f9a4
2318,Jérôme Roussillon,fr FRA,DF,Wolfsburg,de Bundesliga,28,1993,19.7,14,9,8,6,0,10,16,62.5,6,24,5,19,14,28,34,2,Matches,13203c45
2319,Nicolò Rovella,it ITA,MF,Genoa,it Serie A,19,2001,16.3,37,26,16,14,7,15,40,37.5,25,21,1,20,20,57,20,0,Matches,e58cbfd5
2320,Jon Rowe,eng ENG,MFFW,Norwich City,eng Premier League,18,2003,2.5,3,2,2,1,0,2,3,66.7,1,7,0,7,3,6,1,0,Matches,8c12f884
2321,Amir Rrahmani,xk KVX,DF,Napoli,it Serie A,27,1994,32.5,21,11,15,5,1,15,19,78.9,4,36,25,11,19,40,89,0,Matches,4b3e1a38
2322,Ruan,br BRA,DF,Sassuolo,it Serie A,22,1999,2.4,7,4,7,0,0,3,4,75.0,1,6,5,1,2,9,24,1,Matches,a378a02a
2323,Rubén,es ESP,DF,Espanyol,es La Liga,20,2001,1.7,6,1,4,2,0,4,7,57.1,3,0,0,0,2,8,4,0,Matches,35d4f151
2324,John Ruddy,eng ENG,GK,Wolves,eng Premier League,34,1986,1.5,0,0,0,0,0,0,0,,0,0,0,0,0,0,3,0,Matches,da8b19e2
2325,Antonio Rüdiger,de GER,DF,Chelsea,eng Premier League,28,1993,33.7,48,28,29,15,4,36,48,75.0,12,20,11,9,28,76,91,1,Matches,18b896d6
2326,Sebastian Rudy,de GER,MF,Hoffenheim,de Bundesliga,31,1990,8.6,22,12,9,13,0,11,21,52.4,10,8,3,5,11,33,8,1,Matches,80f36c88
2327,Daniele Rugani,it ITA,DF,Juventus,it Serie A,27,1994,9.8,8,5,4,4,0,4,7,57.1,3,9,4,5,11,19,47,0,Matches,14b8fcdf
2328,Matteo Ruggeri,it ITA,DF,Salernitana,it Serie A,19,2002,7.5,8,4,5,2,1,7,10,70.0,3,6,1,5,2,10,25,0,Matches,ae9898c5
2329,Mário Rui,pt POR,DF,Napoli,it Serie A,30,1991,33.2,68,43,32,28,8,39,84,46.4,45,31,7,24,40,108,50,0,Matches,0b5a292a
2330,Aitor Ruibal,es ESP,MFDF,Betis,es La Liga,25,1996,9.5,21,15,13,3,5,10,34,29.4,24,8,0,8,8,29,6,0,Matches,a55d8df5
2331,Isma Ruiz,es ESP,MF,Granada,es La Liga,20,2001,3.1,3,1,3,0,0,1,9,11.1,8,5,2,3,3,6,2,0,Matches,6e36226f
2332,Fabián Ruiz Peña,es ESP,MF,Napoli,it Serie A,25,1996,26.5,55,33,22,29,4,29,67,43.3,38,34,1,33,22,77,32,0,Matches,c0c7ff58
2333,Víctor Ruiz,es ESP,DF,Betis,es La Liga,32,1989,15.8,11,9,7,2,2,6,9,66.7,3,18,13,5,29,40,71,1,Matches,b3dc6eca
2334,Gerónimo Rulli,ar ARG,GK,Villarreal,es La Liga,29,1992,32.0,0,0,0,0,0,0,4,0.0,4,0,0,0,1,1,15,5,Matches,625c144a
2335,Lukas Rupp,de GER,MF,Norwich City,eng Premier League,30,1991,8.5,9,4,5,3,1,4,15,26.7,11,11,1,10,9,18,7,0,Matches,3faa1780
2336,Alessandro Russo,it ITA,MF,Salernitana,it Serie A,17,2003,0.3,1,0,1,0,0,0,1,0.0,1,0,0,0,0,1,1,0,Matches,7152082d
2337,Franco Russo,ar ARG,DF,Mallorca,es La Liga,26,1994,16.3,19,10,10,9,0,13,31,41.9,18,14,9,5,27,46,73,1,Matches,b75ac54b
2338,Georginio Rutter,fr FRA,FWMF,Hoffenheim,de Bundesliga,19,2002,17.9,18,13,4,8,6,6,17,35.3,11,29,1,28,6,24,11,1,Matches,c64c01fc
2339,Mathew Ryan,au AUS,GK,Real Sociedad,es La Liga,29,1992,3.0,0,0,0,0,0,0,0,,0,0,0,0,0,0,2,0,Matches,4535e4bb
2340,Julian Ryerson,no NOR,DF,Union Berlin,de Bundesliga,23,1997,15.9,27,15,11,12,4,17,25,68.0,8,12,4,8,16,43,32,0,Matches,009a4f60
2341,Frederik Rønnow,dk DEN,GK,Union Berlin,de Bundesliga,28,1992,7.0,0,0,0,0,0,0,0,,0,0,0,0,0,0,1,0,Matches,a70b8345
2342,José Sá,pt POR,GK,Wolves,eng Premier League,28,1993,36.5,2,1,2,0,0,2,4,50.0,2,0,0,0,2,4,19,5,Matches,903b6e8b
2343,Roli Pereira de Sa,fr FRA,MF,Nantes,fr Ligue 1,24,1996,6.4,12,4,3,5,4,3,20,15.0,17,6,0,6,6,18,3,0,Matches,60f58477
2344,Youssouf Sabaly,sn SEN,DF,Betis,es La Liga,28,1993,8.8,12,10,11,0,1,7,13,53.8,6,11,4,7,13,25,16,1,Matches,fbbb9269
2345,Mathys Saban,fr FRA,MFFW,Saint-Étienne,fr Ligue 1,19,2002,0.8,4,2,2,2,0,1,1,100.0,0,1,0,1,0,4,0,0,Matches,7d9f3d69
2346,Stefano Sabelli,it ITA,DF,Genoa,it Serie A,28,1993,3.9,6,3,3,2,1,3,9,33.3,6,5,1,4,3,9,12,0,Matches,0ccac09c
2347,Abdelhamid Sabiri,ma MAR,MFFW,Sampdoria,it Serie A,24,1996,9.9,34,18,10,15,9,7,25,28.0,18,10,2,8,7,41,3,0,Matches,4830e0af
2348,Marcel Sabitzer,at AUT,MFDF,Bayern Munich,de Bundesliga,27,1994,10.1,18,7,8,8,2,9,19,47.4,10,7,0,7,9,27,10,1,Matches,e280527c
2349,Marcel Sabitzer,at AUT,MF,RB Leipzig,de Bundesliga,27,1994,0.5,2,1,1,1,0,1,1,100.0,0,0,0,0,1,3,0,0,Matches,e280527c
2350,Falaye Sacko,ml MLI,DF,Saint-Étienne,fr Ligue 1,26,1995,7.4,15,10,14,1,0,13,16,81.3,3,11,7,4,4,19,18,2,Matches,6388e356
2351,Alexis Saelemaekers,be BEL,MF,Milan,it Serie A,22,1999,20.7,43,22,12,17,14,15,51,29.4,36,19,0,19,15,58,8,0,Matches,ee251371
2352,Rafiki Said Ahamada,fr FRA,MFFW,Brest,fr Ligue 1,21,2000,1.4,4,3,1,2,1,3,4,75.0,1,2,0,2,0,4,0,0,Matches,c2e5f306
2353,Wesley Saïd,fr FRA,FWMF,Lens,fr Ligue 1,26,1995,7.3,10,5,1,8,1,1,9,11.1,8,4,0,4,2,12,0,0,Matches,90fcf472
2354,Allan Saint-Maximin,fr FRA,FWMF,Newcastle Utd,eng Premier League,24,1997,31.2,13,8,6,4,3,3,17,17.6,14,13,2,11,11,24,3,0,Matches,2b16cb1a
2355,Romain Saïss,ma MAR,DF,Wolves,eng Premier League,31,1990,30.1,40,27,28,11,1,19,33,57.6,14,41,21,20,58,98,158,2,Matches,9fbbcf39
2356,Bukayo Saka,eng ENG,MF,Arsenal,eng Premier League,19,2001,33.1,40,21,12,17,11,13,39,33.3,26,28,2,26,22,62,23,0,Matches,bc7dc64d
2357,Mamadou Sakho,fr FRA,DF,Montpellier,fr Ligue 1,31,1990,28.6,34,22,26,8,0,16,26,61.5,10,41,34,7,41,75,134,4,Matches,87935cf3
2358,Bakary Sako,ml MLI,FWMF,Saint-Étienne,fr Ligue 1,33,1988,1.7,0,0,0,0,0,0,1,0.0,1,3,1,2,0,0,0,0,Matches,381d7d54
2359,Jacopo Sala,it ITA,MF,Spezia,it Serie A,29,1991,9.8,22,11,10,10,2,13,30,43.3,17,6,0,6,14,36,11,0,Matches,da5a981b
2360,Mohamed Salah,eg EGY,FW,Liverpool,eng Premier League,29,1992,30.7,17,8,5,9,3,6,19,31.6,13,7,1,6,6,23,5,0,Matches,e342ad68
2361,Eddie Salcedo,it ITA,MFFW,Spezia,it Serie A,19,2001,4.8,1,1,0,0,1,0,1,0.0,1,2,1,1,0,1,7,1,Matches,0489bb30
2362,William Saliba,fr FRA,DF,Marseille,fr Ligue 1,20,2001,36.0,54,32,36,16,2,27,35,77.1,8,24,16,8,48,102,85,0,Matches,972aeb2a
2363,Romain Salin,fr FRA,GK,Rennes,fr Ligue 1,37,1984,1.0,0,0,0,0,0,0,0,,0,0,0,0,0,0,0,0,Matches,74733221
2364,Mohammed Salisu,gh GHA,DF,Southampton,eng Premier League,22,1999,33.0,80,47,54,22,4,40,65,61.5,25,49,26,23,78,158,158,4,Matches,0b33f6ad
2365,Roland Sallai,hu HUN,MFFW,Freiburg,de Bundesliga,24,1997,17.2,22,16,8,11,3,7,23,30.4,16,12,0,12,11,33,12,0,Matches,bf075f6b
2366,Yoann Salmier,gf GUF,DF,Troyes,fr Ligue 1,28,1992,29.6,58,33,44,11,3,26,34,76.5,8,30,14,16,40,98,94,0,Matches,c3725db2
2367,Salvi,es ESP,MF,Cádiz,es La Liga,30,1991,15.5,20,10,9,8,3,8,20,40.0,12,17,2,15,6,26,11,0,Matches,405f267a
2368,Lazar Samardzic,de GER,MF,Udinese,it Serie A,19,2002,5.4,13,9,4,7,2,7,26,26.9,19,6,0,6,2,15,2,0,Matches,217c93a1
2369,Diadie Samassékou,ml MLI,MF,Hoffenheim,de Bundesliga,25,1996,18.4,41,26,14,21,6,22,45,48.9,23,27,11,16,28,69,26,0,Matches,08593525
2370,Mama Samba Baldé,gw GNB,MFFW,Troyes,fr Ligue 1,25,1995,19.1,40,28,16,14,10,8,26,30.8,18,32,1,31,5,45,9,0,Matches,fb14aa28
2371,Albert Sambi Lokonga,be BEL,MF,Arsenal,eng Premier League,21,1999,12.6,22,18,11,9,2,12,14,85.7,2,12,7,5,13,35,12,4,Matches,1b4f1169
2372,Junior Sambia,fr FRA,DFMF,Montpellier,fr Ligue 1,24,1996,17.0,22,13,12,7,3,13,22,59.1,9,22,3,19,21,43,31,0,Matches,24eb7ed6
2373,Luigi Samele,it ITA,FW,Sassuolo,it Serie A,19,2002,0.1,0,0,0,0,0,0,0,,0,0,0,0,0,0,1,0,Matches,548fea2f
2374,Fede San Emeterio,es ESP,MF,Cádiz,es La Liga,24,1997,9.2,16,5,5,8,3,5,15,33.3,10,5,0,5,8,24,6,0,Matches,efecd633
2375,Antonio Sanabria,py PAR,FW,Torino,it Serie A,25,1996,20.0,3,2,0,1,2,1,4,25.0,3,11,4,7,2,5,10,0,Matches,0a447501
2376,Oihan Sancet,es ESP,FW,Athletic Club,es La Liga,21,2000,15.8,12,7,2,8,2,5,20,25.0,15,2,0,2,5,17,13,0,Matches,bdb624a3
2377,Renato Sanches,pt POR,MFFW,Lille,fr Ligue 1,23,1997,18.3,19,7,8,10,1,9,26,34.6,17,14,3,11,14,33,7,0,Matches,032f894e
2378,Alexis Sánchez,cl CHI,FW,Inter,it Serie A,32,1988,9.8,9,8,0,6,3,2,11,18.2,9,4,0,4,2,11,3,0,Matches,2c0f8e9e
2379,Antonio Sánchez,es ESP,MF,Mallorca,es La Liga,24,1997,18.0,53,24,29,17,7,19,49,38.8,30,32,2,30,32,85,32,1,Matches,a254bbe0
2380,Davinson Sánchez,co COL,DF,Tottenham,eng Premier League,25,1996,18.1,41,22,25,14,2,19,28,67.9,9,24,16,8,30,71,54,3,Matches,da7b447d
2381,Germán Sánchez,es ESP,DF,Granada,es La Liga,34,1986,25.5,27,19,18,9,0,11,20,55.0,9,19,16,3,28,55,137,0,Matches,ea9b2ef9
2382,Juan Sánchez,es ESP,,Sevilla,es La Liga,17,2003,0.1,,0,,,,,,,,,,,0,,,,Matches,ff4f78e1
2383,Manuel Sánchez,es ESP,DF,Osasuna,es La Liga,20,2000,25.1,72,34,41,22,9,43,79,54.4,36,28,3,25,18,90,43,0,Matches,ffacd3d5
2384,Robert Sánchez,es ESP,GK,Brighton,eng Premier League,23,1997,37.0,2,1,2,0,0,1,1,100.0,0,1,0,1,0,2,11,4,Matches,6a713852
2385,Jadon Sancho,eng ENG,MFFW,Manchester Utd,eng Premier League,21,2000,21.1,14,8,9,4,1,8,22,36.4,14,19,0,19,15,29,5,3,Matches,dbf053da
2386,Philippe Sandler,nl NED,DF,Troyes,fr Ligue 1,24,1997,0.8,0,0,0,0,0,0,0,,0,1,1,0,3,3,6,0,Matches,60740e70
2387,Alex Sandro,br BRA,DF,Juventus,it Serie A,30,1991,19.8,27,16,15,9,3,11,25,44.0,14,17,6,11,27,54,40,0,Matches,0d82903c
2388,Leroy Sané,de GER,MF,Bayern Munich,de Bundesliga,25,1996,22.0,28,16,5,19,4,9,24,37.5,15,18,0,18,12,40,2,1,Matches,2b114be3
2389,Oier Sanjurjo,es ESP,MF,Osasuna,es La Liga,35,1986,8.4,10,6,3,7,0,2,19,10.5,17,8,3,5,1,11,9,0,Matches,466824fb
2390,Mohamed Sankoh,nl NED,FW,Stuttgart,de Bundesliga,17,2003,0.0,0,0,0,0,0,0,0,,0,0,0,0,0,0,0,0,Matches,be625686
2391,Morgan Sanson,fr FRA,MF,Aston Villa,eng Premier League,26,1994,4.0,12,8,7,2,3,3,7,42.9,4,13,0,13,10,22,2,1,Matches,6e7f1353
2392,Nicola Sansone,it ITA,MFFW,Bologna,it Serie A,29,1991,10.0,13,7,5,6,2,3,15,20.0,12,1,0,1,4,17,2,0,Matches,7eb97a8e
2393,Baptiste Santamaria,fr FRA,MFDF,Rennes,fr Ligue 1,26,1995,28.0,52,27,15,31,6,24,44,54.5,20,33,12,21,32,84,42,0,Matches,5e22e2a4
2394,Baptiste Santamaria,fr FRA,MF,Freiburg,de Bundesliga,26,1995,0.2,0,0,0,0,0,0,1,0.0,1,0,0,0,1,1,1,0,Matches,5e22e2a4
2395,Federico Santander,py PAR,FWDF,Bologna,it Serie A,30,1991,0.7,2,1,1,1,0,1,1,100.0,0,0,0,0,0,2,0,0,Matches,df85d472
2396,Jesús Santiago,es ESP,MF,Valencia,es La Liga,17,2004,0.9,2,2,1,1,0,0,2,0.0,2,1,0,1,0,2,1,0,Matches,bc49fd34
2397,Samir Santos,br BRA,DF,Watford,eng Premier League,26,1994,18.6,24,11,18,6,0,8,19,42.1,11,21,11,10,43,67,85,3,Matches,92b4758e
2398,Samir Santos,br BRA,DF,Udinese,it Serie A,26,1994,15.8,36,16,22,13,1,15,25,60.0,10,21,7,14,42,78,62,0,Matches,92b4758e
2399,Sergio Santos,es ESP,DF,Real Madrid,es La Liga,20,2001,0.1,0,0,0,0,0,0,0,,0,0,0,0,0,0,0,0,Matches,cf59e05f
2400,Alvaro Sanz,es ESP,MF,Barcelona,es La Liga,20,2001,0.3,0,0,0,0,0,0,1,0.0,1,0,0,0,0,0,0,0,Matches,eaefa2d0
2401,Riccardo Saponara,it ITA,FW,Fiorentina,it Serie A,29,1991,14.3,10,2,1,6,3,6,16,37.5,10,5,0,5,1,11,3,0,Matches,3bb7af3b
2402,Pablo Sarabia,es ESP,FW,Paris S-G,fr Ligue 1,29,1992,0.2,0,0,0,0,0,0,1,0.0,1,0,0,0,0,0,0,0,Matches,9744ff80
2403,Marcelo Saracchi,uy URU,DF,Levante,es La Liga,23,1998,2.1,8,5,6,1,1,2,4,50.0,2,3,0,3,4,12,7,1,Matches,1c96ad85
2404,Josh Sargent,us USA,FWMF,Norwich City,eng Premier League,21,2000,17.5,26,14,15,7,4,14,39,35.9,25,29,2,27,11,37,18,2,Matches,a8d4428b
2405,Jeremy Sarmiento,ec ECU,MFFW,Brighton,eng Premier League,19,2002,0.5,1,1,0,0,1,0,2,0.0,2,2,0,2,0,1,0,0,Matches,ac0d576d
2406,Bouna Sarr,sn SEN,DF,Bayern Munich,de Bundesliga,29,1992,0.7,4,4,2,1,1,4,5,80.0,1,2,1,1,6,10,1,0,Matches,1a4b9094
2407,Ismaila Sarr,sn SEN,MFFW,Watford,eng Premier League,23,1998,20.7,12,7,4,3,5,5,19,26.3,14,10,1,9,9,21,10,0,Matches,bfdb33aa
2408,Malang Sarr,fr FRA,DF,Chelsea,eng Premier League,22,1999,6.1,14,7,10,2,2,7,12,58.3,5,6,3,3,11,25,20,0,Matches,4315f30d
2409,Joan Sastre Vanrell,es ESP,DF,Mallorca,es La Liga,24,1997,2.9,6,3,5,0,1,3,4,75.0,1,3,0,3,2,8,10,0,Matches,f9acf8bf
2410,Giacomo Satalino,it ITA,GK,Sassuolo,it Serie A,22,1999,0.1,0,0,0,0,0,0,0,,0,0,0,0,0,0,0,0,Matches,b1f0b916
2411,Martin Satriano,uy URU,FWMF,Inter,it Serie A,20,2001,0.4,1,0,0,0,1,1,1,100.0,0,0,0,0,0,1,0,0,Matches,86383d0e
2412,Martin Satriano,uy URU,FW,Brest,fr Ligue 1,20,2001,10.4,5,2,1,1,3,2,7,28.6,5,8,0,8,2,7,3,0,Matches,86383d0e
2413,Téji Savanier,fr FRA,MF,Montpellier,fr Ligue 1,29,1991,26.8,46,27,18,19,9,21,59,35.6,38,23,1,22,25,71,12,1,Matches,6bde367b
2414,Esteban Saveljich,me MNE,DF,Rayo Vallecano,es La Liga,30,1991,18.9,18,11,11,7,0,9,15,60.0,6,20,12,8,16,34,69,0,Matches,79f2a5f5
2415,Stefan Savić,me MNE,DF,Atlético Madrid,es La Liga,30,1991,27.1,46,20,25,20,1,29,43,67.4,14,19,12,7,37,83,102,1,Matches,f6ac68c1
2416,Joe Scally,us USA,DF,M'Gladbach,de Bundesliga,18,2002,21.2,40,30,21,14,5,17,41,41.5,24,27,4,23,22,62,38,0,Matches,236f02cd
2417,Giorgio Scalvini,it ITA,DFMF,Atalanta,it Serie A,17,2003,8.5,22,11,13,8,1,9,19,47.4,10,12,1,11,22,44,16,0,Matches,1e9aa637
2418,Gianluca Scamacca,it ITA,FW,Sassuolo,it Serie A,22,1999,23.8,19,14,2,5,12,5,21,23.8,16,16,1,15,5,24,22,1,Matches,8790f988
2419,Dane Scarlett,eng ENG,MF,Tottenham,eng Premier League,17,2004,0.0,0,0,0,0,0,0,0,,0,0,0,0,0,0,0,0,Matches,21945a9e
2420,Kevin Schade,de GER,MFFW,Freiburg,de Bundesliga,19,2001,9.2,9,7,6,2,1,3,10,30.0,7,15,3,12,3,12,16,0,Matches,52afb588
2421,András Schäfer,hu HUN,MF,Union Berlin,de Bundesliga,22,1999,2.7,4,1,3,1,0,0,5,0.0,5,7,1,6,2,6,4,0,Matches,049751d7
2422,Fabian Schär,ch SUI,DF,Newcastle Utd,eng Premier League,29,1991,24.0,16,11,11,3,2,8,16,50.0,8,27,18,9,32,48,95,2,Matches,c8aa95da
2423,Louis Schaub,at AUT,MF,Köln,de Bundesliga,26,1994,7.3,16,10,7,7,2,11,20,55.0,9,17,3,14,3,19,3,0,Matches,b50ec54b
2424,Andrea Schiavone,it ITA,MF,Salernitana,it Serie A,28,1993,6.3,14,8,5,9,0,10,23,43.5,13,13,3,10,8,22,12,0,Matches,4b55eb4d
2425,Patrik Schick,cz CZE,FW,Leverkusen,de Bundesliga,25,1996,23.1,5,2,2,2,1,1,9,11.1,8,6,1,5,3,8,28,0,Matches,5d4f7d61
2426,Kingsley Schindler,de GER,MFDF,Köln,de Bundesliga,28,1993,3.9,1,0,0,0,1,1,5,20.0,4,5,1,4,5,6,5,0,Matches,bd527260
2427,Xaver Schlager,at AUT,MF,Wolfsburg,de Bundesliga,23,1997,11.6,43,20,20,20,3,20,49,40.8,29,25,2,23,9,52,14,0,Matches,8f056768
2428,Keven Schlotterbeck,de GER,DFFW,Freiburg,de Bundesliga,24,1997,3.5,11,5,6,5,0,5,6,83.3,1,7,4,3,11,22,24,1,Matches,f6bdc830
2429,Nico Schlotterbeck,de GER,DF,Freiburg,de Bundesliga,21,1999,30.9,72,43,36,34,2,33,48,68.8,15,41,32,9,56,128,154,1,Matches,34e12499
2430,Jeffrey Schlupp,gh GHA,MFFW,Crystal Palace,eng Premier League,28,1992,20.6,46,25,16,23,7,24,50,48.0,26,39,9,30,18,64,32,0,Matches,3312f911
2431,Kasper Schmeichel,dk DEN,GK,Leicester City,eng Premier League,34,1986,37.0,0,0,0,0,0,0,2,0.0,2,0,0,0,1,1,15,2,Matches,53af52f3
2432,Jonathan Schmid,fr FRA,DF,Freiburg,de Bundesliga,31,1990,6.5,12,6,6,3,3,5,7,71.4,2,7,1,6,6,18,15,0,Matches,088ca1bd
2433,Benno Schmitz,de GER,DF,Köln,de Bundesliga,26,1994,26.9,57,37,21,27,9,42,86,48.8,44,44,8,36,39,96,39,0,Matches,ad00b1a8
2434,David Schnegg,at AUT,DF,Venezia,it Serie A,22,1998,1.6,2,0,1,1,0,1,3,33.3,2,4,0,4,3,5,6,0,Matches,1c341b14
2435,Morgan Schneiderlin,fr FRA,MF,Nice,fr Ligue 1,31,1989,7.2,21,12,9,11,1,6,13,46.2,7,8,2,6,20,41,18,0,Matches,51b41c5c
2436,Alessandro Schöpf,at AUT,MF,Arminia,de Bundesliga,27,1994,26.6,40,22,19,16,5,14,30,46.7,16,31,5,26,30,70,21,1,Matches,106bca06
2437,Jerdy Schouten,nl NED,MF,Bologna,it Serie A,24,1997,15.5,25,17,10,12,3,9,22,40.9,13,22,5,17,33,58,29,1,Matches,2cfae697
2438,Nico Schulz,de GER,DF,Dortmund,de Bundesliga,28,1993,9.3,21,12,9,7,5,9,21,42.9,12,8,1,7,11,32,8,0,Matches,fa274d97
2439,Marvin Schwäbe,de GER,GK,Köln,de Bundesliga,26,1995,21.0,0,0,0,0,0,0,0,,0,0,0,0,0,0,8,1,Matches,87436846
2440,Alexander Schwolow,de GER,GK,Hertha BSC,de Bundesliga,29,1992,24.2,0,0,0,0,0,0,1,0.0,1,0,0,0,2,2,18,3,Matches,0d55d942
2441,Valentino Scotta,es ESP,DF,Sevilla,es La Liga,19,2001,0.0,0,0,0,0,0,0,0,,0,0,0,0,0,0,0,0,Matches,98529579
2442,Demba Seck,sn SEN,MFFW,Torino,it Serie A,20,2001,1.6,2,1,0,2,0,0,0,,0,0,0,0,0,2,0,0,Matches,16463a79
2443,Aleksandar Sedlar,rs SRB,DFMF,Mallorca,es La Liga,29,1991,4.5,5,3,4,1,0,3,5,60.0,2,4,4,0,5,10,19,0,Matches,a35134ae
2444,Paul Seguin,de GER,MF,Greuther Fürth,de Bundesliga,26,1995,23.4,50,31,15,32,3,26,56,46.4,30,27,3,24,19,69,30,1,Matches,8872ed17
2445,Alidu Seidu,gh GHA,DF,Clermont Foot,fr Ligue 1,21,2000,15.7,34,20,20,13,1,16,27,59.3,11,25,11,14,34,68,49,1,Matches,cea59f02
2446,Davie Selke,de GER,FW,Hertha BSC,de Bundesliga,26,1995,11.2,5,4,1,3,1,1,3,33.3,2,6,1,5,1,6,11,0,Matches,1238a3f9
2447,Matz Sels,be BEL,GK,Strasbourg,fr Ligue 1,29,1992,37.0,1,1,1,0,0,0,0,,0,0,0,0,1,2,22,0,Matches,834b5c4c
2448,Ken Sema,se SWE,MFFW,Watford,eng Premier League,27,1993,9.5,16,6,11,4,1,9,20,45.0,11,10,0,10,5,21,11,0,Matches,1770bd68
2449,Nélson Semedo,pt POR,MFDF,Wolves,eng Premier League,27,1993,23.7,58,39,39,17,2,25,49,51.0,24,23,4,19,21,79,64,1,Matches,d04b94db
2450,Lion Semić,de GER,DF,Dortmund,de Bundesliga,17,2003,0.0,0,0,0,0,0,0,0,,0,0,0,0,0,0,0,0,Matches,87ebd8c9
2451,Adrian Šemper,hr CRO,GK,Genoa,it Serie A,23,1998,1.0,0,0,0,0,0,0,0,,0,0,0,0,0,0,0,0,Matches,f02dde20
2452,Stefano Sensi,it ITA,MFFW,Sampdoria,it Serie A,25,1995,8.4,18,9,10,6,2,10,23,43.5,13,2,0,2,6,24,4,0,Matches,b70bde8f
2453,Stefano Sensi,it ITA,MFFW,Inter,it Serie A,25,1995,1.9,4,3,1,3,0,2,4,50.0,2,2,0,2,0,4,2,0,Matches,b70bde8f
2454,Luigi Sepe,it ITA,GK,Salernitana,it Serie A,30,1991,15.5,0,0,0,0,0,0,0,,0,0,0,0,1,1,3,0,Matches,343f753a
2455,Suat Serdar,de GER,MF,Hertha BSC,de Bundesliga,24,1997,24.6,64,30,24,29,11,25,55,45.5,30,32,3,29,20,84,14,0,Matches,b3325a30
2456,Laurens Serpe,it ITA,DF,Genoa,it Serie A,20,2001,0.5,1,0,1,0,0,1,2,50.0,1,0,0,0,0,1,1,0,Matches,79d60e74
2457,Janni Serra,de GER,FW,Arminia,de Bundesliga,23,1998,12.4,4,2,2,0,2,2,7,28.6,5,8,3,5,5,9,19,0,Matches,40b58bfc
2458,Javier Serrano,es ESP,MF,Atlético Madrid,es La Liga,18,2003,0.8,3,1,0,3,0,2,4,50.0,2,0,0,0,3,6,2,0,Matches,0a8fd9cb
2459,Nicolás Serrano,es ESP,MFFW,Athletic Club,es La Liga,18,2003,3.5,9,6,3,5,1,3,10,30.0,7,5,1,4,2,11,3,0,Matches,2ad0e5e5
2460,Zidan Sertdemir,dk DEN,MF,Leverkusen,de Bundesliga,16,2005,0.2,2,2,2,0,0,0,0,,0,0,0,0,0,2,0,0,Matches,eec1f7f4
2461,Ryan Sessegnon,eng ENG,DFMF,Tottenham,eng Premier League,21,2000,11.6,25,19,14,7,4,11,22,50.0,11,18,3,15,7,32,26,0,Matches,6aa3e78b
2462,Nils Seufert,de GER,MF,Greuther Fürth,de Bundesliga,24,1997,1.1,3,2,1,1,1,0,1,0.0,1,0,0,0,0,3,0,0,Matches,0da32a38
2463,Salva Sevilla,es ESP,MF,Mallorca,es La Liga,37,1984,16.7,18,12,8,8,2,6,17,35.3,11,12,6,6,14,32,11,0,Matches,75bd85ea
2464,Stephan El Shaarawy,it ITA,MFFW,Roma,it Serie A,28,1992,11.7,13,8,4,9,0,4,6,66.7,2,10,2,8,11,24,8,0,Matches,d3aaad90
2465,Jamie Shackleton,eng ENG,DFMF,Leeds United,eng Premier League,21,1999,7.9,27,16,19,7,1,13,25,52.0,12,11,7,4,8,35,12,1,Matches,8d03ca5a
2466,Xherdan Shaqiri,ch SUI,MF,Lyon,fr Ligue 1,29,1991,7.5,7,3,0,5,2,2,10,20.0,8,2,0,2,2,9,2,0,Matches,6421ec64
2467,Luke Shaw,eng ENG,DF,Manchester Utd,eng Premier League,26,1995,17.8,21,13,9,9,3,12,21,57.1,9,22,11,11,9,30,22,2,Matches,9c94165b
2468,Jonjo Shelvey,eng ENG,MF,Newcastle Utd,eng Premier League,29,1992,22.0,30,17,12,18,0,14,34,41.2,20,22,7,15,22,52,20,2,Matches,3727dd3c
2469,Aimar Sher,se SWE,MF,Spezia,it Serie A,18,2002,0.5,2,1,1,1,0,0,1,0.0,1,1,0,1,3,5,1,0,Matches,ef301f96
2470,Eldor Shomurodov,uz UZB,FWMF,Roma,it Serie A,26,1995,8.7,5,4,0,4,1,1,10,10.0,9,8,0,8,2,7,5,0,Matches,57469b2d
2471,Shola Shoretire,eng ENG,MF,Manchester Utd,eng Premier League,17,2004,0.2,0,0,0,0,0,0,0,,0,0,0,0,0,0,0,0,Matches,00f0482f
2472,Mahame Siby,ml MLI,DF,Strasbourg,fr Ligue 1,25,1996,0.2,0,0,0,0,0,0,0,,0,0,0,0,1,1,2,0,Matches,6d075c67
2473,Aboubakar Sidibé,fr FRA,DF,Clermont Foot,fr Ligue 1,25,1996,0.1,0,0,0,0,0,0,0,,0,0,0,0,0,0,0,0,Matches,ae5b93a0
2474,Alassane Sidibe,ci CIV,MF,Atalanta,it Serie A,19,2002,0.1,1,1,1,0,0,0,0,,0,0,0,0,0,1,0,0,Matches,f944979d
2475,Djibril Sidibé,fr FRA,DFMF,Monaco,fr Ligue 1,29,1992,10.5,24,13,13,8,3,9,24,37.5,15,10,1,9,16,40,13,0,Matches,4c5b714f
2476,Kaj Sierhuis,nl NED,FW,Reims,fr Ligue 1,23,1998,0.9,1,1,1,0,0,1,3,33.3,2,0,0,0,0,1,1,0,Matches,9c2b1f11
2477,Francisco Sierralta,cl CHI,DF,Watford,eng Premier League,24,1997,4.7,7,3,7,0,0,5,8,62.5,3,7,2,5,6,13,35,0,Matches,0f933743
2478,Arnór Sigurðsson,is ISL,FWMF,Venezia,it Serie A,22,1999,2.0,1,1,0,1,0,1,2,50.0,1,2,0,2,1,2,0,0,Matches,f209b81e
2479,Kiliann Sildillia,fr FRA,DFMF,Freiburg,de Bundesliga,19,2002,1.9,7,3,3,4,0,3,6,50.0,3,1,0,1,2,9,7,1,Matches,313254a3
2480,Adrien Silva,pt POR,MF,Sampdoria,it Serie A,32,1989,12.0,24,12,14,5,5,9,33,27.3,24,15,5,10,23,47,23,0,Matches,d6f88a1d
2481,André Silva,pt POR,FW,RB Leipzig,de Bundesliga,25,1995,23.1,13,9,2,3,8,4,13,30.8,9,20,2,18,2,15,15,0,Matches,3effaa34
2482,Bernardo Silva,pt POR,MFFW,Manchester City,eng Premier League,26,1994,31.7,57,29,19,19,19,31,67,46.3,36,24,2,22,20,77,19,0,Matches,3eb22ec9
2483,Caio Henrique Oliveira Silva,br BRA,DFMF,Monaco,fr Ligue 1,24,1997,29.6,53,30,31,18,4,28,59,47.5,31,30,6,24,27,80,37,3,Matches,30af8b93
2484,David Silva,es ESP,MF,Real Sociedad,es La Liga,35,1986,19.1,28,17,10,11,7,3,20,15.0,17,13,3,10,7,35,12,0,Matches,e2716bd0
2485,Fábio Silva,pt POR,FW,Wolves,eng Premier League,19,2002,6.4,3,2,0,2,1,0,8,0.0,8,2,0,2,1,4,1,0,Matches,e7aa9d7c
2486,Gabriel Silva,br BRA,DFMF,Saint-Étienne,fr Ligue 1,30,1991,7.9,12,7,7,2,3,9,13,69.2,4,9,3,6,17,29,13,0,Matches,4914ed4a
2487,Jonathan Silva,ar ARG,DFFW,Getafe,es La Liga,27,1994,2.5,10,8,4,4,2,7,12,58.3,5,4,0,4,3,13,7,0,Matches,f2308b33
2488,Rui Silva,pt POR,GK,Betis,es La Liga,27,1994,21.8,1,0,1,0,0,1,2,50.0,1,0,0,0,1,2,11,1,Matches,ea83bfa6
2489,Thiago Silva,br BRA,DF,Chelsea,eng Premier League,36,1984,29.4,32,21,19,12,1,11,22,50.0,11,54,31,23,44,76,100,0,Matches,86e7deaf
2490,Marco Silvestri,it ITA,GK,Udinese,it Serie A,30,1991,35.0,0,0,0,0,0,0,1,0.0,1,0,0,0,1,1,11,1,Matches,0d422df7
2491,Mohamed Simakan,fr FRA,DF,RB Leipzig,de Bundesliga,21,2000,22.3,48,27,25,21,2,27,41,65.9,14,22,11,11,40,88,46,1,Matches,fcb27134
2492,Giovanni Simeone,ar ARG,FW,Hellas Verona,it Serie A,26,1995,29.5,27,15,6,12,9,9,39,23.1,30,37,3,34,6,33,23,0,Matches,343c0d52
2493,Giovanni Simeone,ar ARG,FW,Cagliari,it Serie A,26,1995,0.1,0,0,0,0,0,0,0,,0,0,0,0,0,0,0,0,Matches,343c0d52
2494,Giuliano Simeone,ar ARG,MF,Atlético Madrid,es La Liga,18,2002,0.0,0,0,0,0,0,0,0,,0,0,0,0,0,0,0,0,Matches,a6536561
2495,Ellis Simms,eng ENG,FW,Everton,eng Premier League,20,2001,0.7,0,0,0,0,0,0,0,,0,1,1,0,0,0,1,0,Matches,26d3b5be
2496,Moses Simon,ng NGA,MFFW,Nantes,fr Ligue 1,26,1995,25.9,17,11,6,5,6,11,23,47.8,12,14,3,11,12,29,5,0,Matches,5f3eaaf5
2497,Unai Simón,es ESP,GK,Athletic Club,es La Liga,24,1997,34.0,0,0,0,0,0,0,0,,0,0,0,0,1,1,5,1,Matches,5dcf3e90
2498,Xavi Simons,nl NED,MFFW,Paris S-G,fr Ligue 1,18,2003,1.5,1,1,0,1,0,1,2,50.0,1,3,0,3,0,1,0,0,Matches,da4d670f
2499,Wilfried Singo,ci CIV,DF,Torino,it Serie A,20,2000,29.0,55,35,24,24,7,24,34,70.6,10,26,6,20,23,78,47,0,Matches,8b609c34
2500,Daley Sinkgraven,nl NED,DFMF,Leverkusen,de Bundesliga,26,1995,3.9,6,2,4,0,2,3,7,42.9,4,3,1,2,3,9,6,0,Matches,73000a79
2501,Tobias Sippel,de GER,GK,M'Gladbach,de Bundesliga,33,1988,1.0,0,0,0,0,0,0,0,,0,0,0,0,0,0,0,0,Matches,0d8a37c2
2502,Hugo Siquet,be BEL,DF,Freiburg,de Bundesliga,19,2002,0.2,0,0,0,0,0,0,0,,0,0,0,0,0,0,0,0,Matches,c6cf860f
2503,Salvatore Sirigu,it ITA,GK,Genoa,it Serie A,34,1987,37.0,1,1,1,0,0,1,2,50.0,1,0,0,0,0,1,19,2,Matches,10dc46f0
2504,Issouf Sissokho,ml MLI,MF,Bordeaux,fr Ligue 1,19,2002,4.8,17,8,2,13,2,8,17,47.1,9,8,1,7,7,24,0,0,Matches,792a9d41
2505,Ibrahima Sissoko,fr FRA,MFDF,Strasbourg,fr Ligue 1,23,1997,25.6,47,23,18,20,9,19,46,41.3,27,32,11,21,35,82,31,0,Matches,0f8418aa
2506,Moussa Sissoko,fr FRA,MF,Watford,eng Premier League,31,1989,35.8,53,27,27,20,6,28,42,66.7,14,42,13,29,30,83,64,0,Matches,2acd49b9
2507,Nelson Sissoko,fr FRA,DF,Saint-Étienne,fr Ligue 1,24,1997,0.5,2,0,2,0,0,1,1,100.0,0,0,0,0,0,2,2,0,Matches,12bd0579
2508,Sambou Sissoko,fr FRA,MFDF,Reims,fr Ligue 1,22,1999,2.0,12,6,6,4,2,6,8,75.0,2,2,0,2,2,14,7,0,Matches,e4bb1f08
2509,Antonio Sivera,es ESP,GK,Alavés,es La Liga,24,1996,3.1,0,0,0,0,0,0,1,0.0,1,0,0,0,0,0,0,0,Matches,9970da54
2510,Ellyes Skhiri,tn TUN,MF,Köln,de Bundesliga,26,1995,20.2,55,33,25,26,4,22,41,53.7,19,41,7,34,37,92,35,1,Matches,c2211709
2511,Oliver Skipp,eng ENG,MF,Tottenham,eng Premier League,20,2000,15.0,33,19,14,18,1,15,31,48.4,16,19,7,12,12,45,10,1,Matches,6250083a
2512,Leo Skiri Østigård,no NOR,DF,Genoa,it Serie A,21,1999,13.0,16,9,8,7,1,9,11,81.8,2,17,10,7,8,24,55,1,Matches,b35a7399
2513,Łukasz Skorupski,pl POL,GK,Bologna,it Serie A,30,1991,36.0,0,0,0,0,0,0,1,0.0,1,0,0,0,0,0,17,0,Matches,ab4449d6
2514,Andreas Skov Olsen,dk DEN,DFMF,Bologna,it Serie A,21,1999,8.3,12,10,4,4,4,5,11,45.5,6,9,1,8,3,15,11,0,Matches,c50cee19
2515,Robert Skov,dk DEN,FWDF,Hoffenheim,de Bundesliga,25,1996,4.1,3,2,1,1,1,2,9,22.2,7,2,0,2,3,6,3,0,Matches,ff98492b
2516,Milan Škriniar,sk SVK,DF,Inter,it Serie A,26,1995,35.0,47,27,26,17,4,24,42,57.1,18,36,25,11,25,72,90,1,Matches,30f5ffa9
2517,Islam Slimani,dz ALG,FW,Lyon,fr Ligue 1,33,1988,6.4,3,2,0,1,2,1,6,16.7,5,4,0,4,2,5,5,0,Matches,ffec9769
2518,William Smallbone,ie IRL,MFFW,Southampton,eng Premier League,21,2000,1.5,4,4,2,2,0,1,3,33.3,2,4,0,4,2,6,0,0,Matches,5e105217
2519,Chris Smalling,eng ENG,DF,Roma,it Serie A,31,1989,23.2,36,23,28,8,0,18,25,72.0,7,32,24,8,26,62,92,1,Matches,b6964eb6
2520,Emile Smith Rowe,eng ENG,MF,Arsenal,eng Premier League,21,2000,21.3,14,7,7,7,0,4,20,20.0,16,18,1,17,15,29,10,1,Matches,17695062
2521,Cédric Soares,pt POR,DF,Arsenal,eng Premier League,29,1991,16.5,38,26,23,9,6,16,25,64.0,9,18,7,11,16,54,31,1,Matches,839c14e1
2522,Danilo Soares,br BRA,DF,Bochum,de Bundesliga,29,1991,28.5,109,71,61,39,9,56,84,66.7,28,63,9,54,62,171,65,2,Matches,c05f2f8c
2523,Rubén Sobrino,es ESP,MF,Valencia,es La Liga,29,1992,0.2,1,1,1,0,0,1,1,100.0,0,1,0,1,2,3,0,0,Matches,19b776e9
2524,Rubén Sobrino,es ESP,MFFW,Cádiz,es La Liga,29,1992,20.7,28,17,11,10,7,5,35,14.3,30,21,1,20,21,49,18,0,Matches,19b776e9
2525,Alex Sola,es ESP,DFMF,Real Sociedad,es La Liga,22,1999,0.5,1,1,1,0,0,1,3,33.3,2,1,0,1,2,3,3,0,Matches,5fa714d5
2526,Augusto Solari,ar ARG,MFDF,Celta Vigo,es La Liga,29,1992,7.9,24,12,9,12,3,12,32,37.5,20,14,4,10,7,31,10,1,Matches,3ca6106c
2527,Roberto Soldado,es ESP,FW,Levante,es La Liga,36,1985,7.4,3,1,0,1,2,1,3,33.3,2,4,0,4,1,4,7,0,Matches,9d66fbe3
2528,Carlos Soler,es ESP,MF,Valencia,es La Liga,24,1997,27.5,29,19,10,15,4,11,37,29.7,26,19,4,15,14,43,28,0,Matches,fed17f5a
2529,Yann Sommer,ch SUI,GK,M'Gladbach,de Bundesliga,32,1988,33.0,0,0,0,0,0,0,2,0.0,2,0,0,0,3,3,8,3,Matches,420c18a1
2530,Son,es ESP,DFMF,Levante,es La Liga,27,1994,21.9,28,18,16,7,5,17,34,50.0,17,11,5,6,19,47,33,1,Matches,037dbd30
2531,Brandon Soppy,fr FRA,DFMF,Udinese,it Serie A,19,2002,8.6,20,9,8,10,2,11,16,68.8,5,10,2,8,5,25,9,1,Matches,28f66c2e
2532,David Soria,es ESP,GK,Getafe,es La Liga,28,1993,37.9,1,0,1,0,0,1,2,50.0,1,0,0,0,0,1,22,2,Matches,8f8c6934
2533,Roberto Soriano,it ITA,MF,Bologna,it Serie A,30,1991,29.1,57,30,27,22,8,17,56,30.4,39,37,3,34,22,79,32,0,Matches,9d4c45d6
2534,Alberto Soro,es ESP,MFDF,Granada,es La Liga,22,1999,6.4,12,10,3,6,3,1,7,14.3,6,21,2,19,3,15,4,0,Matches,452c3055
2535,Borna Sosa,hr CRO,DFFW,Stuttgart,de Bundesliga,23,1998,27.8,22,12,14,5,3,12,26,46.2,14,30,3,27,26,48,61,0,Matches,af0d79a9
2536,Hugo Sotelo,es ESP,FW,Celta Vigo,es La Liga,17,2003,0.0,0,0,0,0,0,0,0,,0,0,0,0,0,0,0,0,Matches,3aa74860
2537,Florian Sotoca,fr FRA,FWMF,Lens,fr Ligue 1,30,1990,27.6,31,19,7,20,4,12,51,23.5,39,31,4,27,25,56,41,0,Matches,7a42d0df
2538,Riccardo Sottil,it ITA,FW,Fiorentina,it Serie A,22,1999,13.8,9,4,4,4,1,3,9,33.3,6,3,0,3,1,10,2,0,Matches,94816803
2539,Tomáš Souček,cz CZE,MF,West Ham,eng Premier League,26,1995,34.0,66,32,27,33,6,28,65,43.1,37,34,13,21,52,118,98,1,Matches,6613c819
2540,Matìas Soulé,ar ARG,MF,Juventus,it Serie A,18,2003,0.1,0,0,0,0,0,0,1,0.0,1,0,0,0,0,0,0,0,Matches,c13ddd3e
2541,Sambou Soumano,sn SEN,FWMF,Lorient,fr Ligue 1,20,2001,5.0,4,1,1,2,1,2,2,100.0,0,3,0,3,1,5,7,0,Matches,7cc00776
2542,Adama Soumaoro,fr FRA,DF,Bologna,it Serie A,29,1992,25.2,15,5,5,8,2,4,9,44.4,5,22,16,6,34,49,95,0,Matches,7b075c75
2543,Boubakary Soumaré,fr FRA,MF,Leicester City,eng Premier League,22,1999,12.2,19,13,10,8,1,8,17,47.1,9,13,1,12,14,33,18,0,Matches,ae59b359
2544,Arnaud Souquet,fr FRA,DF,Montpellier,fr Ligue 1,29,1992,25.9,56,35,30,17,9,32,65,49.2,33,21,7,14,34,90,60,1,Matches,4e0afc5d
2545,Djibril Sow,ch SUI,MF,Eint Frankfurt,de Bundesliga,24,1997,26.8,57,33,28,25,4,22,60,36.7,38,35,8,27,50,107,20,1,Matches,4c6facae
2546,Saidou Sow,gn GUI,DF,Saint-Étienne,fr Ligue 1,19,2002,11.0,28,17,21,6,1,16,21,76.2,5,15,5,10,23,51,34,0,Matches,f6b94e8d
2547,Çağlar Söyüncü,tr TUR,DF,Leicester City,eng Premier League,25,1996,27.7,47,30,32,12,3,26,42,61.9,16,44,27,17,32,79,115,1,Matches,21166ff4
2548,Leonardo Spinazzola,it ITA,DF,Roma,it Serie A,28,1993,1.4,0,0,0,0,0,0,1,0.0,1,4,1,3,0,0,3,0,Matches,3626daea
2549,Marco Sportiello,it ITA,GK,Atalanta,it Serie A,29,1992,5.0,0,0,0,0,0,0,0,,0,0,0,0,0,0,2,0,Matches,ac4003af
2550,Tony Springett,eng ENG,MF,Norwich City,eng Premier League,18,2002,1.6,2,1,1,1,0,1,4,25.0,3,0,0,0,0,2,2,0,Matches,35be8087
2551,Jerry St. Juste,nl NED,DF,Mainz 05,de Bundesliga,24,1996,6.7,13,9,7,6,0,7,8,87.5,1,7,3,4,14,27,14,0,Matches,90339309
2552,Anton Stach,de GER,MF,Mainz 05,de Bundesliga,22,1998,20.7,28,19,14,13,1,15,38,39.5,23,24,5,19,51,79,25,0,Matches,0f59a7bf
2553,Kostas Stafylidis,gr GRE,DFMF,Bochum,de Bundesliga,27,1993,15.4,39,27,22,14,3,21,27,77.8,6,19,6,13,31,70,44,0,Matches,861e0116
2554,Luca Stanga,it ITA,DF,Milan,it Serie A,19,2002,0.0,1,0,0,1,0,0,0,,0,0,0,0,0,1,0,0,Matches,2967bcd0
2555,Josip Stanišić,hr CRO,DF,Bayern Munich,de Bundesliga,21,2000,7.2,21,10,7,12,2,12,18,66.7,6,7,0,7,11,32,10,2,Matches,7ed08d5c
2556,Niklas Stark,de GER,DFMF,Hertha BSC,de Bundesliga,26,1995,22.6,28,16,18,10,0,12,17,70.6,5,27,17,10,36,64,122,2,Matches,aad48be9
2557,Jason Steele,eng ENG,GK,Brighton,eng Premier League,30,1990,1.0,0,0,0,0,0,0,0,,0,0,0,0,0,0,0,0,Matches,28300a16
2558,Jed Steer,eng ENG,GK,Aston Villa,eng Premier League,28,1992,1.0,0,0,0,0,0,0,0,,0,0,0,0,0,0,0,0,Matches,a8a3d139
2559,Renato Steffen,ch SUI,MFDF,Wolfsburg,de Bundesliga,29,1991,10.7,20,16,10,10,0,9,16,56.3,7,7,0,7,13,33,14,0,Matches,dd669209
2560,Zack Steffen,us USA,GK,Manchester City,eng Premier League,26,1995,1.0,0,0,0,0,0,0,0,,0,0,0,0,0,0,2,0,Matches,42130443
2561,Calvin Stengs,nl NED,MF,Nice,fr Ligue 1,22,1998,11.9,16,7,6,9,1,7,20,35.0,13,10,0,10,8,24,6,0,Matches,8f7e6783
2562,Pascal Stenzel,de GER,DF,Stuttgart,de Bundesliga,25,1996,10.0,24,11,15,5,4,17,33,51.5,16,13,3,10,11,35,25,0,Matches,99f7e9aa
2563,Dale Stephens,eng ENG,MF,Burnley,eng Premier League,32,1989,1.4,4,1,0,3,1,3,8,37.5,5,4,1,3,1,5,1,0,Matches,653ee42d
2564,Jack Stephens,eng ENG,DF,Southampton,eng Premier League,27,1994,9.0,19,12,13,5,1,6,16,37.5,10,12,7,5,19,38,42,0,Matches,6adbc307
2565,Raheem Sterling,eng ENG,FWMF,Manchester City,eng Premier League,26,1994,23.6,23,10,3,11,9,10,23,43.5,13,12,0,12,12,35,3,0,Matches,b400bde0
2566,Finley Stevens,wls WAL,DF,Brentford,eng Premier League,18,2003,0.2,3,1,0,3,0,1,1,100.0,0,0,0,0,0,3,0,0,Matches,7e003182
2567,Angelo Stiller,de GER,MF,Hoffenheim,de Bundesliga,20,2001,18.8,30,17,11,15,4,9,23,39.1,14,32,6,26,9,39,16,2,Matches,3b1ed320
2568,Lars Stindl,de GER,MFFW,M'Gladbach,de Bundesliga,32,1988,18.1,23,15,6,14,3,9,33,27.3,24,28,2,26,10,33,14,0,Matches,7cd6badb
2569,Riccardo Stivanello,it ITA,DF,Bologna,it Serie A,17,2004,0.5,1,1,1,0,0,1,1,100.0,0,2,2,0,0,1,6,0,Matches,90e1d9dc
2570,Kevin Stöger,at AUT,MF,Mainz 05,de Bundesliga,27,1993,4.7,10,5,5,5,0,4,10,40.0,6,6,0,6,5,15,1,1,Matches,e5649a78
2571,Petar Stojanović,si SVN,DF,Empoli,it Serie A,25,1995,30.4,96,63,55,32,9,59,114,51.8,55,39,13,26,27,123,65,1,Matches,13b44b02
2572,John Stones,eng ENG,DF,Manchester City,eng Premier League,27,1994,12.4,5,3,3,2,0,2,3,66.7,1,3,3,0,11,16,27,1,Matches,5eecec3d
2573,Thomas Strakosha,al ALB,GK,Lazio,it Serie A,26,1995,23.0,0,0,0,0,0,0,0,,0,0,0,0,0,0,7,2,Matches,339fe0e8
2574,Stefan Strandberg,no NOR,DF,Salernitana,it Serie A,31,1990,10.4,13,8,10,3,0,8,11,72.7,3,15,13,2,9,22,49,0,Matches,6d5e62b0
2575,Dávid Strelec,sk SVK,MFFW,Spezia,it Serie A,20,2001,5.6,4,4,1,2,1,2,9,22.2,7,8,1,7,2,6,1,0,Matches,2cb9486d
2576,Tobias Strobl,de GER,MFDF,Augsburg,de Bundesliga,31,1990,3.6,8,3,3,5,0,3,11,27.3,8,7,2,5,7,15,3,0,Matches,17780d2b
2577,Kevin Strootman,nl NED,MF,Cagliari,it Serie A,31,1990,7.1,8,4,2,4,2,5,12,41.7,7,11,2,9,10,18,15,0,Matches,ef2e5e1a
2578,Pascal Struijk,nl NED,DFMF,Leeds United,eng Premier League,21,1999,22.8,61,39,34,23,4,30,50,60.0,20,35,23,12,33,94,60,2,Matches,f4d296e4
2579,Jens Stryger Larsen,dk DEN,DF,Udinese,it Serie A,30,1991,7.6,5,2,3,1,1,2,3,66.7,1,2,0,2,4,9,17,0,Matches,f91e81c9
2580,Leo Štulac,si SVN,MF,Empoli,it Serie A,26,1994,9.3,13,6,5,6,2,7,19,36.8,12,6,2,4,8,21,15,0,Matches,92948398
2581,Stefano Sturaro,it ITA,MF,Genoa,it Serie A,28,1993,19.6,43,26,16,16,11,22,48,45.8,26,25,1,24,15,58,29,2,Matches,2334478a
2582,Damián Suárez,uy URU,DF,Getafe,es La Liga,33,1988,30.1,74,47,34,30,10,42,91,46.2,49,46,5,41,31,105,30,0,Matches,ba5004e1
2583,Denis Suárez,es ESP,MF,Celta Vigo,es La Liga,27,1994,31.3,61,29,20,33,8,25,82,30.5,57,32,4,28,16,77,11,0,Matches,12c50af5
2584,Luis Suárez,uy URU,FW,Atlético Madrid,es La Liga,34,1987,20.4,8,5,2,4,2,2,10,20.0,8,8,1,7,1,9,14,0,Matches,a6154613
2585,Mario Suárez,es ESP,DF,Rayo Vallecano,es La Liga,34,1987,7.9,9,4,7,2,0,3,9,33.3,6,6,4,2,7,16,37,1,Matches,7106f0a0
2586,Isaac Success,ng NGA,FWMF,Udinese,it Serie A,25,1996,10.1,5,2,0,3,2,1,5,20.0,4,2,0,2,2,7,6,0,Matches,f573a8bf
2587,Niklas Süle,de GER,DF,Bayern Munich,de Bundesliga,25,1995,20.4,29,23,21,7,1,18,24,75.0,6,16,12,4,28,57,49,0,Matches,e33c06cf
2588,Kamaldeen Sulemana,gh GHA,MFFW,Rennes,fr Ligue 1,19,2002,11.3,23,12,7,9,7,10,17,58.8,7,10,1,9,4,27,5,0,Matches,a62f8bf1
2589,Crysencio Summerville,nl NED,MF,Leeds United,eng Premier League,19,2001,1.4,5,3,1,1,3,2,3,66.7,1,2,0,2,2,7,0,0,Matches,df04eb4b
2590,Vladyslav Supriaha,ua UKR,FW,Sampdoria,it Serie A,21,2000,0.2,0,0,0,0,0,0,1,0.0,1,0,0,0,0,0,0,0,Matches,73affbb6
2591,Suso,es ESP,FWMF,Sevilla,es La Liga,27,1993,4.3,4,3,1,3,0,3,13,23.1,10,4,0,4,0,4,0,0,Matches,4e219ad2
2592,Bosko Sutalo,hr CRO,DF,Hellas Verona,it Serie A,21,2000,10.2,20,13,11,6,3,8,16,50.0,8,10,5,5,17,37,39,0,Matches,1d0bb7e4
2593,Mattias Svanberg,se SWE,MF,Bologna,it Serie A,22,1999,28.5,39,15,15,16,8,16,54,29.6,38,31,9,22,28,67,34,0,Matches,92d83c27
2594,Michael Svoboda,at AUT,DF,Venezia,it Serie A,22,1998,13.7,33,17,26,6,1,18,32,56.3,14,27,15,12,10,43,61,5,Matches,8abd174d
2595,Abdoulaye Sylla,gn GUI,DF,Nantes,fr Ligue 1,21,2000,1.7,4,4,2,1,1,2,4,50.0,2,5,3,2,1,5,3,0,Matches,2aeb43f1
2596,Mamadou Sylla,sn SEN,FWMF,Alavés,es La Liga,27,1994,4.4,2,2,0,1,1,0,1,0.0,1,0,0,0,1,3,5,0,Matches,e5ec95f8
2597,Mamadou Sylla,sn SEN,MFFW,Rayo Vallecano,es La Liga,27,1994,2.8,1,1,1,0,0,0,1,0.0,1,2,0,2,4,5,3,0,Matches,e5ec95f8
2598,Ádám Szalai,hu HUN,FW,Mainz 05,de Bundesliga,33,1987,2.9,3,2,0,2,1,0,2,0.0,2,2,0,2,0,3,0,0,Matches,53e07d0b
2599,Wojciech Szczęsny,pl POL,GK,Juventus,it Serie A,31,1990,33.0,1,1,1,0,0,1,2,50.0,1,0,0,0,0,1,8,1,Matches,01b8a2b2
2600,Dominik Szoboszlai,hu HUN,MF,RB Leipzig,de Bundesliga,20,2000,17.1,17,12,5,9,3,8,27,29.6,19,30,3,27,10,27,15,0,Matches,934e1968
2601,Jakob Sørensen,dk DEN,MFDF,Norwich City,eng Premier League,23,1998,6.7,22,11,6,14,2,10,20,50.0,10,7,3,4,10,32,19,0,Matches,953c30b0
2602,Alexander Sørloth,no NOR,FW,Real Sociedad,es La Liga,25,1995,19.6,20,7,4,10,6,7,17,41.2,10,14,1,13,4,24,15,0,Matches,e92cd3f7
2603,Tachi,es ESP,DF,Alavés,es La Liga,23,1997,2.7,6,3,3,3,0,5,7,71.4,2,4,3,1,1,7,9,0,Matches,8b625720
2604,Jonathan Tah,de GER,DF,Leverkusen,de Bundesliga,25,1996,32.0,25,18,19,5,1,17,34,50.0,17,31,20,11,43,68,156,0,Matches,bd142efb
2605,Waniss Taibi,fr FRA,MFFW,Angers,fr Ligue 1,19,2002,1.5,8,7,4,4,0,2,4,50.0,2,0,0,0,1,9,1,0,Matches,95192fe4
2606,Flavien Tait,fr FRA,MF,Rennes,fr Ligue 1,28,1993,23.6,28,19,13,9,6,13,40,32.5,27,15,4,11,19,47,13,1,Matches,a0f9b535
2607,Adrien Tameze,cm CMR,MFDF,Hellas Verona,it Serie A,27,1994,28.6,52,29,24,21,7,20,59,33.9,39,40,5,35,52,104,41,0,Matches,8da74c05
2608,Japhet Tanganga,eng ENG,DF,Tottenham,eng Premier League,22,1999,8.2,14,8,7,6,1,9,19,47.4,10,13,5,8,9,23,31,0,Matches,e9971f2d
2609,Renato Tapia,pe PER,MF,Celta Vigo,es La Liga,26,1995,15.7,50,31,15,31,4,20,50,40.0,30,21,5,16,28,78,43,0,Matches,34269bdf
2610,Edmond Tapsoba,bf BFA,DF,Leverkusen,de Bundesliga,22,1999,20.2,35,17,24,10,1,20,32,62.5,12,27,15,12,29,64,72,1,Matches,a73c8f95
2611,Florian Tardieu,fr FRA,MF,Troyes,fr Ligue 1,29,1992,29.2,58,25,31,21,6,31,71,43.7,40,31,9,22,42,100,38,0,Matches,ed39121c
2612,Matt Targett,eng ENG,DF,Aston Villa,eng Premier League,25,1995,15.9,34,18,28,5,1,24,45,53.3,21,16,9,7,23,57,35,0,Matches,e514ab62
2613,Matt Targett,eng ENG,DF,Newcastle Utd,eng Premier League,25,1995,16.0,41,26,26,14,1,24,37,64.9,13,15,4,11,25,66,39,1,Matches,e514ab62
2614,Oussama Targhalline,ma MAR,MFFW,Marseille,fr Ligue 1,19,2002,0.1,0,0,0,0,0,0,0,,0,0,0,0,0,0,0,0,Matches,abd56820
2615,James Tarkowski,eng ENG,DF,Burnley,eng Premier League,28,1992,34.5,65,45,47,17,1,33,47,70.2,14,75,61,14,48,113,186,4,Matches,15ea812b
2616,Ciprian Tătărușanu,ro ROU,GK,Milan,it Serie A,35,1986,6.0,0,0,0,0,0,0,1,0.0,1,0,0,0,0,0,2,1,Matches,b056e3da
2617,Niklas Tauer,de GER,DFMF,Mainz 05,de Bundesliga,20,2001,5.4,16,9,9,7,0,9,14,64.3,5,6,2,4,9,25,14,0,Matches,27270af4
2618,Nuno Tavares,pt POR,DF,Arsenal,eng Premier League,21,2000,13.1,21,14,10,7,4,8,18,44.4,10,15,5,10,9,30,33,1,Matches,a65c844b
2619,Charlie Taylor,eng ENG,DF,Burnley,eng Premier League,27,1993,30.3,45,26,31,11,3,26,44,59.1,18,42,20,22,58,103,95,2,Matches,cc2d7ad5
2620,Loum Tchaouna,fr FRA,MFFW,Rennes,fr Ligue 1,17,2003,1.0,3,1,1,2,0,1,5,20.0,4,0,0,0,2,5,0,0,Matches,a3c8b4d3
2621,Warren Tchimbembé,cg CGO,MF,Metz,fr Ligue 1,23,1998,2.3,1,1,0,1,0,0,1,0.0,1,2,1,1,2,3,2,0,Matches,93b8f9f4
2622,Aurélien Tchouaméni,fr FRA,MF,Monaco,fr Ligue 1,21,2000,32.5,86,45,33,49,4,29,55,52.7,26,39,7,32,101,187,34,0,Matches,4f255115
2623,Mathys Tel,fr FRA,MFFW,Rennes,fr Ligue 1,16,2005,0.6,2,1,1,1,0,0,0,,0,0,0,0,1,3,2,0,Matches,829aa60c
2624,Jordan Tell,fr FRA,MFFW,Clermont Foot,fr Ligue 1,24,1997,3.2,5,5,0,3,2,1,4,25.0,3,3,0,3,0,5,1,0,Matches,4f093689
2625,Nathan Tella,eng ENG,MFFW,Southampton,eng Premier League,22,1999,8.9,13,9,5,7,1,6,18,33.3,12,13,0,13,6,19,9,0,Matches,f1e94cd6
2626,Alex Telles,br BRA,DF,Manchester Utd,eng Premier League,28,1992,18.4,48,27,35,9,4,27,43,62.8,16,17,4,13,26,74,45,0,Matches,e73c9bb2
2627,Cristian Tello,es ESP,MF,Betis,es La Liga,29,1991,9.1,17,11,6,7,4,13,31,41.9,18,9,0,9,10,27,6,0,Matches,72a99e38
2628,Nahuel Tenaglia,ar ARG,DF,Alavés,es La Liga,25,1996,11.9,42,27,30,9,3,24,37,64.9,13,10,2,8,26,68,42,0,Matches,66654daa
2629,Marc Tenas,es ESP,MFDF,Alavés,es La Liga,20,2001,0.6,1,1,1,0,0,1,1,100.0,0,1,0,1,0,1,0,1,Matches,1c5d79e2
2630,Marc-André ter Stegen,de GER,GK,Barcelona,es La Liga,29,1992,35.0,0,0,0,0,0,0,1,0.0,1,0,0,0,1,1,13,5,Matches,6f51e382
2631,Filippo Terracciano,it ITA,DF,Hellas Verona,it Serie A,18,2003,0.1,0,0,0,0,0,0,0,,0,0,0,0,0,0,1,0,Matches,5cbb5ad6
2632,Pietro Terracciano,it ITA,GK,Fiorentina,it Serie A,31,1990,31.8,0,0,0,0,0,0,4,0.0,4,0,0,0,2,2,20,1,Matches,e1b0a70d
2633,Martin Terrier,fr FRA,FWMF,Rennes,fr Ligue 1,24,1997,30.9,55,33,22,16,17,25,43,58.1,18,29,3,26,18,73,17,0,Matches,5148dcc5
2634,Aleksa Terzić,rs SRB,DF,Fiorentina,it Serie A,21,1999,3.0,8,5,3,3,2,4,7,57.1,3,7,0,7,4,12,5,0,Matches,3ef0a2d7
2635,Robert Tesche,de GER,MF,Bochum,de Bundesliga,34,1987,3.9,6,4,4,1,1,5,7,71.4,2,6,2,4,5,11,5,1,Matches,037130ca
2636,Tanner Tessmann,us USA,MF,Venezia,it Serie A,19,2001,7.6,11,5,4,6,1,5,14,35.7,9,19,9,10,5,16,22,0,Matches,ac277993
2637,Tetê,br BRA,FWMF,Lyon,fr Ligue 1,21,2000,6.5,10,5,4,5,1,3,13,23.1,10,4,0,4,3,13,1,0,Matches,7120a04d
2638,Cedric Teuchert,de GER,MFFW,Union Berlin,de Bundesliga,24,1997,1.2,3,2,3,0,0,2,6,33.3,4,1,0,1,0,3,0,0,Matches,f956479d
2639,Arthur Theate,be BEL,DF,Bologna,it Serie A,21,2000,26.9,33,19,26,3,4,14,31,45.2,17,29,16,13,43,76,69,0,Matches,df8d6029
2640,Jan Thielmann,de GER,MFFW,Köln,de Bundesliga,19,2002,13.2,24,16,6,12,6,8,23,34.8,15,23,2,21,10,34,11,0,Matches,fd53759d
2641,Sada Thioub,sn SEN,FW,Angers,fr Ligue 1,26,1995,0.0,0,0,0,0,0,0,0,,0,0,0,0,0,0,0,0,Matches,f4bc42b1
2642,Sada Thioub,sn SEN,DFMF,Saint-Étienne,fr Ligue 1,26,1995,10.6,13,8,5,8,0,6,14,42.9,8,9,0,9,10,23,8,0,Matches,f4bc42b1
2643,Luke Thomas,eng ENG,DF,Leicester City,eng Premier League,20,2001,21.2,50,31,33,13,4,28,65,43.1,37,35,14,21,40,90,55,0,Matches,fc027d02
2644,Romain Thomas,fr FRA,DF,Angers,fr Ligue 1,33,1988,28.5,49,37,28,21,0,30,57,52.6,27,35,19,16,44,93,126,0,Matches,275e2c51
2645,Adrien Thomasson,fr FRA,MF,Strasbourg,fr Ligue 1,27,1993,26.5,64,31,18,27,19,30,93,32.3,63,56,4,52,29,93,16,1,Matches,c76b7567
2646,Erik Thommy,de GER,MFFW,Stuttgart,de Bundesliga,26,1994,3.0,2,0,0,2,0,1,2,50.0,1,3,0,3,4,6,0,0,Matches,df8e7b62
2647,Dominic Thompson,eng ENG,DF,Brentford,eng Premier League,21,2000,1.6,1,0,1,0,0,0,1,0.0,1,2,2,0,2,3,3,0,Matches,235a62f8
2648,Morten Thorsby,no NOR,MF,Sampdoria,it Serie A,25,1996,32.7,46,26,15,23,8,28,56,50.0,28,37,12,25,25,71,39,0,Matches,d1b49282
2649,Thuler,br BRA,DF,Montpellier,fr Ligue 1,22,1999,9.5,21,12,17,4,0,8,15,53.3,7,9,7,2,9,30,30,0,Matches,db23d9fc
2650,Marcus Thuram,fr FRA,FWMF,M'Gladbach,de Bundesliga,23,1997,10.9,6,5,0,5,1,1,4,25.0,3,5,0,5,5,11,7,0,Matches,6f8cd6d0
2651,Khéphren Thuram-Ulie,fr FRA,MF,Nice,fr Ligue 1,20,2001,21.1,33,19,11,18,4,17,35,48.6,18,31,11,20,28,61,19,0,Matches,7d9397f8
2652,Alexis Tibidi,fr FRA,MFFW,Stuttgart,de Bundesliga,17,2003,4.3,7,3,1,3,3,3,4,75.0,1,4,0,4,3,10,2,0,Matches,ca6f4846
2653,Cheikh Tidiane Sabaly,sn SEN,FWMF,Metz,fr Ligue 1,22,1999,1.7,6,3,1,4,1,2,2,100.0,0,1,0,1,0,6,1,0,Matches,9ddf7fae
2654,Youri Tielemans,be BEL,MF,Leicester City,eng Premier League,24,1997,29.2,74,38,23,45,6,42,100,42.0,58,47,13,34,21,95,41,3,Matches,56f7a928
2655,Kieran Tierney,sct SCO,DF,Arsenal,eng Premier League,24,1997,21.3,18,14,11,7,0,10,11,90.9,1,23,5,18,15,33,54,0,Matches,fce2302c
2656,Steffen Tigges,de GER,FWMF,Dortmund,de Bundesliga,23,1998,1.2,4,3,1,2,1,2,3,66.7,1,3,1,2,0,4,3,0,Matches,6b8887c2
2657,Malik Tillman,us USA,MF,Bayern Munich,de Bundesliga,19,2002,1.2,2,1,0,1,1,0,1,0.0,1,5,1,4,2,4,1,0,Matches,a5420709
2658,Timothy Tillman,de GER,MF,Greuther Fürth,de Bundesliga,22,1999,22.3,43,26,17,18,8,19,42,45.2,23,33,4,29,12,55,26,0,Matches,a5bea1fb
2659,David Timor,es ESP,MF,Getafe,es La Liga,31,1989,3.8,1,1,1,0,0,0,3,0.0,3,3,2,1,1,2,4,1,Matches,174651c8
2660,Jean-Clair Todibo,fr FRA,DF,Nice,fr Ligue 1,21,1999,34.6,59,37,43,15,1,39,60,65.0,21,45,21,24,51,110,130,2,Matches,88f130ed
2661,Umut Tohumcu,de GER,MF,Hoffenheim,de Bundesliga,16,2004,0.1,0,0,0,0,0,0,0,,0,0,0,0,0,0,0,0,Matches,e547d3cf
2662,Karl Toko Ekambi,cm CMR,MFFW,Lyon,fr Ligue 1,28,1992,25.5,13,7,4,6,3,4,21,19.0,17,26,0,26,20,33,5,0,Matches,5ceba7fc
2663,Corentin Tolisso,fr FRA,MF,Bayern Munich,de Bundesliga,26,1994,7.8,11,5,1,9,1,7,17,41.2,10,5,1,4,9,20,10,0,Matches,652d4c37
2664,Jeremy Toljan,de GER,DF,Sassuolo,it Serie A,26,1994,15.5,18,10,12,4,2,13,20,65.0,7,12,5,7,12,30,41,0,Matches,a96e5dc0
2665,Rafael Tolói,it ITA,DF,Atalanta,it Serie A,30,1990,16.0,38,15,12,15,11,24,39,61.5,15,23,11,12,26,64,35,0,Matches,c56dc39e
2666,Raúl de Tomás,es ESP,FW,Espanyol,es La Liga,26,1994,32.4,15,11,6,7,2,6,17,35.3,11,12,3,9,6,21,42,1,Matches,02ef8778
2667,Tiago Tomás,pt POR,FW,Stuttgart,de Bundesliga,19,2002,11.9,8,4,0,7,1,0,6,0.0,6,3,0,3,4,12,1,0,Matches,b492126a
2668,Takehiro Tomiyasu,jp JPN,DF,Arsenal,eng Premier League,22,1998,18.7,35,17,19,13,3,21,32,65.6,11,22,3,19,24,59,64,2,Matches,b3af9be1
2669,Takehiro Tomiyasu,jp JPN,DF,Bologna,it Serie A,22,1998,0.1,0,0,0,0,0,0,0,,0,1,0,1,1,1,0,0,Matches,b3af9be1
2670,James Tomkins,eng ENG,DF,Crystal Palace,eng Premier League,32,1989,6.1,8,3,6,2,0,6,8,75.0,2,8,8,0,4,12,18,0,Matches,e7ca0439
2671,Fikayo Tomori,eng ENG,DF,Milan,it Serie A,23,1997,30.2,73,44,36,34,3,18,26,69.2,8,37,23,14,45,118,84,1,Matches,7edfbb8a
2672,Sandro Tonali,it ITA,MF,Milan,it Serie A,21,2000,28.9,54,37,23,25,6,21,41,51.2,20,26,8,18,34,88,19,0,Matches,0db169ae
2673,Lorenzo Tonelli,it ITA,DF,Empoli,it Serie A,31,1990,9.7,17,9,11,4,2,6,13,46.2,7,14,8,6,19,36,28,2,Matches,8cc29864
2674,Ivan Toney,eng ENG,FW,Brentford,eng Premier League,25,1996,32.3,33,21,5,20,8,12,38,31.6,26,16,2,14,14,47,44,1,Matches,e09f279b
2675,Ernesto Torregrossa,it ITA,FW,Sampdoria,it Serie A,29,1992,1.3,2,1,1,0,1,1,2,50.0,1,0,0,0,0,2,1,0,Matches,bf39bdec
2676,Lucas Torreira,uy URU,MF,Fiorentina,it Serie A,25,1996,24.4,37,29,13,21,3,18,40,45.0,22,18,1,17,26,63,18,0,Matches,52611641
2677,Raúl Torrente,es ESP,DF,Granada,es La Liga,19,2001,14.2,31,21,18,11,2,16,29,55.2,13,14,9,5,12,43,69,0,Matches,4d753a3f
2678,Ferrán Torres,es ESP,FW,Manchester City,eng Premier League,21,2000,3.4,2,2,0,1,1,0,3,0.0,3,2,0,2,0,2,1,0,Matches,9e1035f8
2679,Ferrán Torres,es ESP,FW,Barcelona,es La Liga,21,2000,15.7,10,5,3,4,3,3,7,42.9,4,12,3,9,6,16,7,0,Matches,9e1035f8
2680,Óliver Torres,es ESP,MFFW,Sevilla,es La Liga,26,1994,11.2,22,12,8,7,7,8,25,32.0,17,10,1,9,6,28,4,0,Matches,58a9a4d9
2681,Pau Torres,es ESP,DF,Villarreal,es La Liga,24,1997,31.7,32,19,23,7,2,18,25,72.0,7,32,23,9,19,51,105,2,Matches,532e1e4f
2682,Roberto Torres,es ESP,MFFW,Osasuna,es La Liga,32,1989,9.0,7,4,3,1,3,3,15,20.0,12,8,0,8,8,15,4,0,Matches,d733aa38
2683,Lucas Torró,es ESP,MF,Osasuna,es La Liga,27,1994,30.3,71,40,25,38,8,29,57,50.9,28,32,11,21,47,118,55,0,Matches,0e4fef6e
2684,Jordan Torunarigha,de GER,DF,Hertha BSC,de Bundesliga,23,1997,5.4,4,1,1,3,0,4,5,80.0,1,4,2,2,17,21,30,0,Matches,f86cabbd
2685,Cenk Tosun,tr TUR,MF,Everton,eng Premier League,30,1991,0.1,0,0,0,0,0,0,0,,0,0,0,0,0,0,0,0,Matches,9a104dee
2686,Abdoulaye Touré,fr FRA,MF,Genoa,it Serie A,27,1994,4.8,12,4,3,8,1,5,11,45.5,6,6,1,5,4,16,6,0,Matches,ef7cd87a
2687,Almamy Touré,ml MLI,DFMF,Eint Frankfurt,de Bundesliga,25,1996,5.6,12,9,8,3,1,4,17,23.5,13,10,3,7,5,17,19,0,Matches,c8c60119
2688,Lucas Tousart,fr FRA,MF,Hertha BSC,de Bundesliga,24,1997,21.8,42,25,15,22,5,10,34,29.4,24,30,6,24,35,77,55,0,Matches,71ec39ef
2689,Yoann Touzghar,tn TUN,FW,Troyes,fr Ligue 1,34,1986,16.2,5,2,1,3,1,1,3,33.3,2,3,1,2,3,8,8,0,Matches,4e47507a
2690,Andros Townsend,eng ENG,MFFW,Everton,eng Premier League,30,1991,16.2,31,17,15,6,10,15,40,37.5,25,28,2,26,14,45,6,1,Matches,b28bbd58
2691,Adama Traoré,es ESP,FWMF,Wolves,eng Premier League,25,1996,11.9,8,3,6,0,2,3,7,42.9,4,4,1,3,2,10,1,0,Matches,9a28eba4
2692,Adama Traoré,es ESP,FW,Barcelona,es La Liga,25,1996,4.2,4,2,0,3,1,3,5,60.0,2,2,0,2,4,8,3,1,Matches,9a28eba4
2693,Amadou Traore,fr FRA,MF,Bordeaux,fr Ligue 1,19,2002,0.2,0,0,0,0,0,0,0,,0,0,0,0,0,0,0,0,Matches,4eb0686f
2694,Bertrand Traoré,bf BFA,MFFW,Aston Villa,eng Premier League,25,1995,2.4,3,3,0,1,2,1,2,50.0,1,0,0,0,0,3,1,0,Matches,c47541e0
2695,Boubacar Traoré,ml MLI,MF,Metz,fr Ligue 1,19,2001,19.2,43,26,18,23,2,10,39,25.6,29,29,5,24,25,68,11,1,Matches,999ceb5f
2696,Charles Traore,ml MLI,DF,Nantes,fr Ligue 1,29,1992,8.0,16,12,10,4,2,2,13,15.4,11,11,4,7,15,31,30,0,Matches,de488e56
2697,Hamari Traoré,ml MLI,DF,Rennes,fr Ligue 1,29,1992,32.1,63,36,25,26,12,41,59,69.5,18,29,8,21,37,100,81,1,Matches,a4b1028a
2698,Ismaël Traoré,ci CIV,DF,Angers,fr Ligue 1,34,1986,35.7,28,17,16,11,1,13,28,46.4,15,25,17,8,44,72,122,1,Matches,b666421b
2699,Kevin Trapp,de GER,GK,Eint Frankfurt,de Bundesliga,31,1990,32.0,0,0,0,0,0,0,1,0.0,1,0,0,0,1,1,13,2,Matches,ce17b5eb
2700,Miguel Trauco,pe PER,DFMF,Saint-Étienne,fr Ligue 1,28,1992,12.4,25,18,16,8,1,12,22,54.5,10,13,4,9,23,48,17,0,Matches,e4b72e34
2701,Óscar Trejo,ar ARG,MF,Rayo Vallecano,es La Liga,33,1988,22.3,42,24,14,18,10,15,50,30.0,35,26,1,25,13,55,11,0,Matches,fc647b34
2702,Trézéguet,eg EGY,FW,Aston Villa,eng Premier League,26,1994,0.1,0,0,0,0,0,0,0,,0,0,0,0,0,0,0,0,Matches,3ae14ed1
2703,Manu Trigueros,es ESP,MFFW,Villarreal,es La Liga,29,1991,24.2,45,25,16,18,11,23,66,34.8,43,19,3,16,13,58,17,0,Matches,963829d0
2704,Simone Trimboli,it ITA,MF,Sampdoria,it Serie A,19,2002,0.7,2,1,2,0,0,2,2,100.0,0,0,0,0,2,4,0,0,Matches,f5f21026
2705,Christopher Trimmel,at AUT,DFFW,Union Berlin,de Bundesliga,34,1987,22.1,49,30,25,19,5,26,45,57.8,19,20,3,17,34,83,75,0,Matches,056d2d95
2706,Francisco Trincão,pt POR,FWMF,Wolves,eng Premier League,21,1999,14.8,28,15,9,13,6,3,19,15.8,16,17,1,16,12,40,1,1,Matches,77e39b04
2707,Kieran Trippier,eng ENG,DF,Newcastle Utd,eng Premier League,30,1990,4.8,17,10,8,8,1,10,16,62.5,6,10,3,7,10,27,10,0,Matches,21512407
2708,Kieran Trippier,eng ENG,DFFW,Atlético Madrid,es La Liga,30,1990,10.8,22,12,12,5,5,12,21,57.1,9,12,1,11,10,32,11,0,Matches,21512407
2709,William Troost-Ekong,ng NGA,DF,Watford,eng Premier League,27,1993,15.4,18,9,11,6,1,10,15,66.7,5,24,14,10,7,25,82,1,Matches,7ed4921e
2710,Leandro Trossard,be BEL,FWMF,Brighton,eng Premier League,26,1994,31.2,34,20,12,9,13,4,31,12.9,27,33,4,29,15,49,10,0,Matches,38ceb24a
2711,Adrien Truffert,fr FRA,DF,Rennes,fr Ligue 1,19,2001,18.2,29,21,17,9,3,11,24,45.8,13,25,5,20,19,48,30,0,Matches,5d0e0a1f
2712,Philipp Tschauner,de GER,GK,RB Leipzig,de Bundesliga,35,1985,0.0,0,0,0,0,0,0,0,,0,0,0,0,0,0,0,0,Matches,73e2f6eb
2713,Kostas Tsimikas,gr GRE,DF,Liverpool,eng Premier League,25,1996,9.7,27,12,12,8,7,12,16,75.0,4,6,2,4,10,37,22,2,Matches,f315ca93
2714,Axel Tuanzebe,eng ENG,DF,Aston Villa,eng Premier League,23,1997,5.6,5,3,3,2,0,2,5,40.0,3,5,4,1,5,10,12,1,Matches,2baec6ce
2715,Axel Tuanzebe,eng ENG,DF,Napoli,it Serie A,23,1997,0.1,0,0,0,0,0,0,0,,0,1,1,0,0,0,0,0,Matches,2baec6ce
2716,Ozan Tufan,tr TUR,MF,Watford,eng Premier League,26,1995,3.7,3,2,1,1,1,1,5,20.0,4,2,0,2,2,5,4,0,Matches,17d45fb2
2717,Beñat Turrientes,es ESP,MF,Real Sociedad,es La Liga,19,2002,2.3,0,0,0,0,0,0,4,0.0,4,1,0,1,2,2,2,0,Matches,068f4dec
2718,Tuta,br BRA,DF,Eint Frankfurt,de Bundesliga,22,1999,24.3,46,28,20,22,4,26,47,55.3,21,43,15,28,41,87,76,1,Matches,35d64857
2719,Christos Tzolis,gr GRE,MFFW,Norwich City,eng Premier League,19,2002,3.7,5,3,3,1,1,2,9,22.2,7,3,0,3,1,6,1,0,Matches,9f333379
2720,Iyenoma Udogie,it ITA,DF,Udinese,it Serie A,18,2002,27.5,64,40,30,27,7,33,60,55.0,27,39,6,33,27,91,42,0,Matches,7cd520e8
2721,Matthieu Udol,fr FRA,DF,Metz,fr Ligue 1,25,1996,11.2,23,14,11,10,2,12,18,66.7,6,20,7,13,31,54,29,1,Matches,cc41f558
2722,Ike Ugbo,ca CAN,FW,Troyes,fr Ligue 1,22,1998,9.0,3,1,0,1,2,0,1,0.0,1,4,1,3,2,5,1,0,Matches,8a53d24b
2723,Chimuanya Ugochukwu,fr FRA,MF,Rennes,fr Ligue 1,17,2004,4.5,13,9,5,5,3,9,19,47.4,10,7,2,5,4,17,2,0,Matches,1df4a109
2724,Hwang Ui-jo,kr KOR,FW,Bordeaux,fr Ligue 1,28,1992,27.9,10,4,4,4,2,4,13,30.8,9,9,1,8,5,15,18,0,Matches,a2d873dd
2725,Anthony Ujah,ng NGA,FWMF,Union Berlin,de Bundesliga,30,1990,0.4,0,0,0,0,0,0,0,,0,0,0,0,0,0,0,0,Matches,99be8fb5
2726,Maximilian Ullmann,at AUT,DF,Venezia,it Serie A,25,1996,2.7,0,0,0,0,0,0,1,0.0,1,4,0,4,2,2,7,0,Matches,caaf2ed1
2727,Sven Ulreich,de GER,GK,Bayern Munich,de Bundesliga,32,1988,6.0,0,0,0,0,0,0,0,,0,0,0,0,0,0,1,0,Matches,7d3e7da6
2728,Samuel Umtiti,fr FRA,DF,Barcelona,es La Liga,27,1993,1.0,2,2,2,0,0,1,2,50.0,1,1,1,0,0,2,4,0,Matches,3eed9821
2729,Enes Ünal,tr TUR,FW,Getafe,es La Liga,24,1997,31.1,37,22,2,18,17,5,42,11.9,37,25,5,20,5,42,36,0,Matches,f8eca1b6
2730,Cengiz Ünder,tr TUR,FWMF,Marseille,fr Ligue 1,24,1997,24.4,18,13,5,6,7,5,18,27.8,13,13,2,11,14,32,9,0,Matches,1880614f
2731,Dayot Upamecano,fr FRA,DF,Bayern Munich,de Bundesliga,22,1998,24.6,66,42,42,21,3,24,36,66.7,12,20,10,10,32,98,71,6,Matches,d248cd8f
2732,Benjamin Uphoff,de GER,GK,Freiburg,de Bundesliga,27,1993,2.0,0,0,0,0,0,0,0,,0,0,0,0,0,0,2,2,Matches,a9a6fc08
2733,Kacper Urbanski,pl POL,MF,Bologna,it Serie A,16,2004,0.5,3,2,1,2,0,2,2,100.0,0,2,0,2,0,3,0,0,Matches,2d9d9e42
2734,Jere Uronen,fi FIN,DF,Brest,fr Ligue 1,27,1994,9.8,28,15,15,10,3,14,24,58.3,10,12,3,9,16,44,21,0,Matches,d75f3980
2735,Mark Uth,de GER,MFFW,Köln,de Bundesliga,29,1991,22.5,32,20,9,14,9,15,49,30.6,34,27,1,26,14,46,13,0,Matches,a3ddb1b9
2736,Myrto Uzuni,al ALB,MFFW,Granada,es La Liga,26,1995,9.5,7,4,6,1,0,0,2,0.0,2,13,1,12,10,17,7,0,Matches,01da7812
2737,Antonio Vacca,it ITA,MF,Venezia,it Serie A,31,1990,11.8,36,20,24,10,2,14,36,38.9,22,16,8,8,20,56,16,0,Matches,444c89d9
2738,Álvaro Vadillo,es ESP,DFMF,Espanyol,es La Liga,26,1994,0.1,1,1,1,0,0,1,2,50.0,1,0,0,0,0,1,1,0,Matches,61b62b33
2739,Óscar Valentín,es ESP,MF,Rayo Vallecano,es La Liga,26,1994,28.5,102,53,46,51,5,44,105,41.9,61,56,10,46,39,141,43,0,Matches,592f3158
2740,Germán Valera,es ESP,FWMF,Real Sociedad,es La Liga,19,2002,0.6,3,2,3,0,0,1,1,100.0,0,0,0,0,0,3,1,0,Matches,84f55b4a
2741,Yan Valery,tn TUN,DF,Southampton,eng Premier League,22,1999,4.1,8,6,4,3,1,4,9,44.4,5,6,3,3,6,14,19,1,Matches,531a4aa8
2742,Martin Valjent,sk SVK,DF,Mallorca,es La Liga,25,1995,35.3,31,19,18,12,1,13,24,54.2,11,34,26,8,31,62,173,1,Matches,f2c6ac01
2743,Jesús Vallejo,es ESP,DF,Real Madrid,es La Liga,24,1997,3.8,7,5,7,0,0,5,6,83.3,1,9,8,1,6,13,16,0,Matches,c2111b45
2744,Manu Vallejo,es ESP,MFFW,Alavés,es La Liga,24,1997,4.1,8,2,1,4,3,4,13,30.8,9,7,0,7,0,8,4,0,Matches,0bc4e720
2745,Manu Vallejo,es ESP,FWMF,Valencia,es La Liga,24,1997,1.1,2,1,1,1,0,0,1,0.0,1,0,0,0,0,2,1,0,Matches,0bc4e720
2746,Federico Valverde,uy URU,MF,Real Madrid,es La Liga,23,1998,20.4,36,16,11,16,9,12,31,38.7,19,23,5,18,24,60,12,0,Matches,0959c2a2
2747,Virgil van Dijk,nl NED,DF,Liverpool,eng Premier League,30,1991,34.0,16,10,11,5,0,11,16,68.8,5,21,14,7,31,47,109,0,Matches,e06683ca
2748,Vanderson,br BRA,MFDF,Monaco,fr Ligue 1,20,2001,12.4,35,19,10,19,6,15,23,65.2,8,17,4,13,13,48,12,0,Matches,ee45fd85
2749,Zinho Vanheusden,be BEL,DF,Genoa,it Serie A,22,1999,11.0,18,6,12,5,1,8,14,57.1,6,19,14,5,23,41,42,0,Matches,afbf187b
2750,Jonathan Varane,fr FRA,MF,Lens,fr Ligue 1,19,2001,0.0,0,0,0,0,0,0,0,,0,0,0,0,0,0,0,0,Matches,4ade359f
2751,Raphaël Varane,fr FRA,DF,Manchester Utd,eng Premier League,28,1993,20.3,28,19,21,6,1,10,22,45.5,12,18,9,9,18,46,82,1,Matches,9f8e9423
2752,Jamie Vardy,eng ENG,FW,Leicester City,eng Premier League,34,1987,20.1,6,5,0,4,2,1,7,14.3,6,9,0,9,1,7,17,0,Matches,45963054
2753,Ruben Vargas,ch SUI,MFFW,Augsburg,de Bundesliga,22,1998,22.0,28,21,7,14,7,11,30,36.7,19,9,1,8,16,44,13,0,Matches,6ecbddf6
2754,Sebastian Vasiliadis,gr GRE,MF,Arminia,de Bundesliga,23,1997,13.3,31,17,12,15,4,15,42,35.7,27,15,2,13,25,56,31,1,Matches,d3112d86
2755,Johan Vásquez,mx MEX,DF,Genoa,it Serie A,22,1998,25.3,79,46,44,32,3,48,75,64.0,27,32,10,22,42,121,85,0,Matches,5eaed77a
2756,Denis Vavro,sk SVK,DF,Lazio,it Serie A,25,1996,0.1,0,0,0,0,0,0,0,,0,0,0,0,0,0,0,0,Matches,08990838
2757,José Luis García Vayá,es ESP,MF,Levante,es La Liga,22,1998,22.4,46,27,10,31,5,16,41,39.0,25,24,5,19,38,84,30,0,Matches,27dc1378
2758,Jesus Vazquez,es ESP,DF,Valencia,es La Liga,18,2003,9.0,24,13,10,8,6,10,22,45.5,12,16,3,13,9,33,19,0,Matches,106c142c
2759,Kevin Vázquez,es ESP,DF,Celta Vigo,es La Liga,28,1993,14.8,34,24,12,13,9,14,28,50.0,14,20,7,13,36,70,34,0,Matches,ee923664
2760,Lucas Vázquez,es ESP,DF,Real Madrid,es La Liga,30,1991,20.4,43,22,24,9,10,17,35,48.6,18,25,7,18,20,63,41,1,Matches,fd51b456
2761,Matías Vecino,uy URU,MF,Inter,it Serie A,29,1991,4.2,7,5,2,3,2,3,9,33.3,6,10,1,9,4,11,7,0,Matches,44ac04e9
2762,Gabriel Veiga,es ESP,MF,Celta Vigo,es La Liga,19,2002,1.2,5,4,0,4,1,3,12,25.0,9,2,0,2,4,9,1,0,Matches,35a6e5c7
2763,Miguel Veloso,pt POR,MF,Hellas Verona,it Serie A,35,1986,14.9,23,15,4,17,2,10,16,62.5,6,18,5,13,11,34,18,1,Matches,ab1ca213
2764,Joël Veltman,nl NED,DF,Brighton,eng Premier League,29,1992,31.9,74,48,47,21,6,21,53,39.6,32,46,16,30,45,119,89,0,Matches,dad4b285
2765,Mickey van de Ven,nl NED,DF,Wolfsburg,de Bundesliga,20,2001,2.1,4,4,3,1,0,0,1,0.0,1,4,1,3,2,6,8,0,Matches,8fe2a392
2766,Unai Vencedor Paris,es ESP,MF,Athletic Club,es La Liga,20,2000,26.5,26,11,11,9,6,8,42,19.0,34,31,13,18,19,45,22,0,Matches,4112ace5
2767,Lorenzo Venuti,it ITA,DF,Fiorentina,it Serie A,26,1995,17.5,25,10,13,10,2,14,24,58.3,10,13,4,9,5,30,27,0,Matches,983ff2c7
2768,Daniele Verde,it ITA,MFFW,Spezia,it Serie A,25,1996,21.7,11,4,8,2,1,9,20,45.0,11,17,2,15,18,29,8,0,Matches,d3298c99
2769,Simone Verdi,it ITA,MFFW,Torino,it Serie A,29,1992,0.5,1,1,0,1,0,0,0,,0,0,0,0,0,1,0,0,Matches,0375723e
2770,Simone Verdi,it ITA,MFFW,Salernitana,it Serie A,29,1992,9.2,12,8,5,2,5,9,20,45.0,11,4,0,4,3,15,1,0,Matches,0375723e
2771,Gonzalo Verdú,es ESP,DF,Elche,es La Liga,32,1988,15.5,19,9,15,4,0,8,16,50.0,8,20,14,6,13,32,59,1,Matches,1c2c55fc
2772,Jordan Veretout,fr FRA,MF,Roma,it Serie A,28,1993,25.8,34,25,20,12,2,15,39,38.5,24,12,1,11,27,61,22,1,Matches,4a56052c
2773,Edoardo Vergani,it ITA,FWMF,Salernitana,it Serie A,20,2001,1.1,2,2,2,0,0,0,0,,0,2,2,0,0,2,2,0,Matches,2873973b
2774,Vincent Vermeij,nl NED,MF,Freiburg,de Bundesliga,26,1994,0.0,0,0,0,0,0,0,0,,0,1,0,1,0,0,0,0,Matches,7e629adc
2775,Marco Verratti,it ITA,MF,Paris S-G,fr Ligue 1,28,1992,21.5,60,40,16,30,14,32,64,50.0,32,36,10,26,18,78,14,2,Matches,1467af0d
2776,Valerio Verre,it ITA,MFFW,Sampdoria,it Serie A,27,1994,4.7,7,5,1,4,2,4,9,44.4,5,7,0,7,0,7,5,0,Matches,33ecf462
2777,Valerio Verre,it ITA,MF,Empoli,it Serie A,27,1994,3.4,4,2,3,1,0,2,7,28.6,5,2,0,2,1,5,0,0,Matches,33ecf462
2778,Freddie Veseli,al ALB,DF,Salernitana,it Serie A,28,1992,6.6,7,2,4,3,0,5,6,83.3,1,10,5,5,4,11,19,0,Matches,d541e703
2779,Mikel Vesga,es ESP,MF,Athletic Club,es La Liga,28,1993,15.1,27,14,7,18,2,11,31,35.5,20,16,5,11,20,47,34,2,Matches,b0fce72c
2780,Jannik Vestergaard,dk DEN,DF,Leicester City,eng Premier League,28,1992,6.3,15,10,12,3,0,8,15,53.3,7,10,8,2,7,22,36,0,Matches,1900032e
2781,Rúben Vezo,pt POR,DF,Levante,es La Liga,27,1994,26.9,41,29,28,12,1,26,41,63.4,15,41,25,16,36,77,105,1,Matches,c67cd65c
2782,Guglielmo Vicario,it ITA,GK,Empoli,it Serie A,24,1996,38.0,1,1,1,0,0,1,1,100.0,0,1,0,1,1,2,21,1,Matches,77d6fd4d
2783,Aleix Vidal,es ESP,DFMF,Espanyol,es La Liga,31,1989,21.1,31,25,17,9,5,19,39,48.7,20,19,6,13,25,56,35,2,Matches,04965583
2784,Arturo Vidal,cl CHI,MF,Inter,it Serie A,34,1987,8.2,26,10,16,9,1,9,26,34.6,17,13,5,8,7,33,7,1,Matches,67cdbc0e
2785,Nacho Vidal,es ESP,DF,Osasuna,es La Liga,26,1995,32.2,83,47,49,25,9,39,77,50.6,38,32,14,18,58,141,79,0,Matches,3a9c4b7b
2786,Gabriel Vidovic,hr CRO,MF,Bayern Munich,de Bundesliga,17,2003,0.4,0,0,0,0,0,0,0,,0,0,0,0,0,0,0,0,Matches,5360a956
2787,Ronaldo Vieira,gw GNB,MF,Sampdoria,it Serie A,23,1998,5.5,,6,,,,,,,,,,,5,,,,Matches,75e60d75
2788,Nick Viergever,nl NED,DF,Greuther Fürth,de Bundesliga,31,1989,23.7,32,23,25,7,0,24,34,70.6,10,31,22,9,37,69,119,1,Matches,e38f1636
2789,Luca Vignali,it ITA,DFMF,Spezia,it Serie A,25,1996,0.9,1,1,0,1,0,0,3,0.0,3,0,0,0,1,2,1,0,Matches,c1e8e74e
2790,Emanuel Vignato,it ITA,MFDF,Bologna,it Serie A,20,2000,6.6,12,7,5,7,0,6,13,46.2,7,2,0,2,2,14,5,0,Matches,ec5dae45
2791,Dídac Vilà,es ESP,DFMF,Espanyol,es La Liga,32,1989,2.3,7,5,2,5,0,4,9,44.4,5,2,1,1,3,10,8,0,Matches,bad38a94
2792,Tonny Vilhena,nl NED,MFFW,Espanyol,es La Liga,26,1995,10.3,16,6,7,8,1,7,21,33.3,14,10,2,8,8,24,17,0,Matches,c7069d87
2793,Daniel Villahermosa,es ESP,MF,Espanyol,es La Liga,20,2001,0.3,0,0,0,0,0,0,0,,0,0,0,0,0,0,1,0,Matches,de903ae2
2794,Asier Villalibre,es ESP,FW,Athletic Club,es La Liga,23,1997,6.1,4,3,2,1,1,1,2,50.0,1,3,1,2,1,5,7,0,Matches,57be54ec
2795,Gonzalo Villar,es ESP,MF,Getafe,es La Liga,23,1998,3.3,5,3,4,1,0,2,5,40.0,3,4,1,3,1,6,1,0,Matches,bdc74a8f
2796,Matías Viña,uy URU,DFFW,Roma,it Serie A,23,1997,17.4,46,30,27,14,5,29,59,49.2,30,26,3,23,25,71,33,0,Matches,08eb3b58
2797,Nicolas Viola,it ITA,MF,Bologna,it Serie A,31,1989,1.1,2,2,1,1,0,1,2,50.0,1,1,1,0,0,2,1,0,Matches,45392b06
2798,Mattia Viti,it ITA,DF,Empoli,it Serie A,19,2002,16.6,28,16,16,9,3,15,24,62.5,9,28,25,3,29,57,69,1,Matches,75438a9a
2799,Vitolo,es ESP,MF,Getafe,es La Liga,31,1989,2.5,3,2,1,1,1,2,5,40.0,3,3,0,3,1,4,1,0,Matches,db750822
2800,Daniel Vivian,es ESP,DF,Athletic Club,es La Liga,22,1999,22.1,32,21,24,7,1,17,24,70.8,7,20,15,5,26,58,107,1,Matches,ab7bf91d
2801,Dušan Vlahović,rs SRB,FW,Fiorentina,it Serie A,21,2000,20.6,5,0,0,2,3,2,11,18.2,9,6,2,4,1,6,16,0,Matches,79443529
2802,Dušan Vlahović,rs SRB,FW,Juventus,it Serie A,21,2000,12.0,0,0,0,0,0,0,4,0.0,4,3,0,3,0,0,7,0,Matches,79443529
2803,Nikola Vlašić,hr CRO,MF,West Ham,eng Premier League,23,1997,6.2,11,7,4,6,1,5,20,25.0,15,4,0,4,2,13,1,0,Matches,aa8e289e
2804,Andreas Voglsammer,de GER,FWMF,Union Berlin,de Bundesliga,29,1992,9.8,14,9,8,3,3,6,14,42.9,8,9,2,7,2,16,7,0,Matches,daa78200
2805,Kevin Vogt,de GER,DF,Hoffenheim,de Bundesliga,29,1991,28.5,21,12,15,6,0,11,21,52.4,10,18,7,11,13,34,101,1,Matches,1d8e9add
2806,Mërgim Vojvoda,xk KVX,DF,Torino,it Serie A,26,1995,22.0,38,23,23,11,4,20,36,55.6,16,27,8,19,20,58,51,0,Matches,be2706c0
2807,Kevin Volland,de GER,MFFW,Monaco,fr Ligue 1,29,1992,27.1,24,10,2,18,4,6,31,19.4,25,20,0,20,3,27,9,0,Matches,64f69877
2808,Cristian Volpato,it ITA,FWMF,Roma,it Serie A,17,2003,0.4,1,1,0,0,1,1,1,100.0,0,0,0,0,0,1,0,0,Matches,72f87f25
2809,Aster Vranckx,be BEL,MF,Wolfsburg,de Bundesliga,18,2002,12.7,34,13,14,16,4,14,26,53.8,12,19,7,12,13,47,16,0,Matches,f86cd5df
2810,Stefan de Vrij,nl NED,DF,Inter,it Serie A,29,1992,26.8,38,29,22,16,0,12,17,70.6,5,17,8,9,32,70,52,0,Matches,d0d8dd44
2811,Šime Vrsaljko,hr CRO,DF,Atlético Madrid,es La Liga,29,1992,10.2,27,17,14,12,1,12,20,60.0,8,10,1,9,12,39,30,0,Matches,46a8347f
2812,Nikola Vukčević,me MNE,MF,Levante,es La Liga,29,1991,1.3,3,2,2,1,0,0,1,0.0,1,2,0,2,2,5,1,0,Matches,4442fbcd
2813,Matěj Vydra,cz CZE,FW,Burnley,eng Premier League,29,1992,7.5,12,7,3,4,5,3,7,42.9,4,5,1,4,0,12,9,0,Matches,0d4ceb32
2814,Walace,br BRA,MF,Udinese,it Serie A,26,1995,33.0,83,49,37,38,8,50,113,44.2,63,51,5,46,54,137,32,1,Matches,26db8853
2815,Theo Walcott,eng ENG,MFFW,Southampton,eng Premier League,32,1989,4.2,4,2,2,0,2,1,5,20.0,4,3,0,3,5,9,2,0,Matches,1ecb65be
2816,Luca Waldschmidt,de GER,MF,Wolfsburg,de Bundesliga,25,1996,8.0,9,1,3,5,1,5,13,38.5,8,5,0,5,8,17,3,0,Matches,e5a35ae9
2817,Kyle Walker,eng ENG,DF,Manchester City,eng Premier League,31,1990,19.5,15,6,7,7,1,8,17,47.1,9,14,4,10,14,29,16,1,Matches,86dd77d1
2818,Kyle Walker-Peters,eng ENG,DF,Southampton,eng Premier League,24,1997,29.3,57,33,28,21,8,26,38,68.4,12,29,8,21,37,94,53,1,Matches,984a5a64
2819,Sebastian Walukiewicz,pl POL,DF,Cagliari,it Serie A,21,2000,3.4,9,5,7,2,0,3,5,60.0,2,5,2,3,7,16,14,0,Matches,217875a4
2820,Aaron Wan-Bissaka,eng ENG,DF,Manchester Utd,eng Premier League,23,1997,19.9,49,36,25,18,6,14,20,70.0,6,24,14,10,34,83,41,2,Matches,9e525177
2821,Paul Wanner,de GER,MFDF,Bayern Munich,de Bundesliga,15,2005,0.4,2,2,0,2,0,1,1,100.0,0,0,0,0,0,2,0,0,Matches,cb64672e
2822,Danny Ward,wls WAL,GK,Leicester City,eng Premier League,28,1993,1.0,0,0,0,0,0,0,0,,0,0,0,0,0,0,1,0,Matches,d3ce0e89
2823,Joel Ward,eng ENG,DF,Crystal Palace,eng Premier League,31,1989,27.6,44,26,30,11,3,30,57,52.6,27,24,11,13,32,76,107,1,Matches,8a7ff278
2824,James Ward-Prowse,eng ENG,MF,Southampton,eng Premier League,26,1994,35.7,41,24,12,24,5,19,70,27.1,51,43,15,28,40,81,45,1,Matches,3515d404
2825,Magnus Warming,dk DEN,MFFW,Torino,it Serie A,21,2000,0.6,1,1,0,1,0,0,0,,0,2,0,2,0,1,0,0,Matches,55e098cd
2826,Daniel Wass,dk DEN,DFFW,Atlético Madrid,es La Liga,32,1989,0.5,0,0,0,0,0,0,0,,0,0,0,0,0,0,3,0,Matches,d83bbc54
2827,Daniel Wass,dk DEN,MF,Valencia,es La Liga,32,1989,17.6,23,13,6,14,3,8,31,25.8,23,13,2,11,13,36,19,0,Matches,d83bbc54
2828,Ollie Watkins,eng ENG,FW,Aston Villa,eng Premier League,25,1995,32.8,17,13,2,7,8,2,15,13.3,13,25,3,22,12,29,27,0,Matches,aed3a70f
2829,Timothy Weah,us USA,MFFW,Lille,fr Ligue 1,21,2000,18.0,19,7,8,8,3,10,20,50.0,10,16,1,15,10,29,7,0,Matches,8eec784d
2830,Adam Webster,eng ENG,DF,Brighton,eng Premier League,26,1995,15.9,26,8,17,7,2,13,20,65.0,7,25,17,8,17,43,66,2,Matches,c40b6180
2831,Wout Weghorst,nl NED,FW,Burnley,eng Premier League,28,1992,16.1,17,9,3,9,5,6,19,31.6,13,16,5,11,6,23,13,0,Matches,c4e87b8b
2832,Wout Weghorst,nl NED,FW,Wolfsburg,de Bundesliga,28,1992,17.3,13,7,3,3,7,7,17,41.2,10,10,3,7,2,15,11,1,Matches,c4e87b8b
2833,Noah Weißhaupt,de GER,MF,Freiburg,de Bundesliga,19,2001,1.1,1,1,1,0,0,1,2,50.0,1,2,0,2,1,2,1,1,Matches,dd676a97
2834,Danny Welbeck,eng ENG,FWMF,Brighton,eng Premier League,30,1990,16.4,14,7,2,8,4,3,10,30.0,7,18,2,16,5,19,18,0,Matches,ce5143da
2835,Timo Werner,de GER,FWMF,Chelsea,eng Premier League,25,1996,14.3,8,4,3,3,2,2,20,10.0,18,9,0,9,2,10,4,0,Matches,49fe9070
2836,Ashley Westwood,eng ENG,MF,Burnley,eng Premier League,31,1990,25.4,21,12,8,12,1,10,31,32.3,21,21,9,12,30,51,16,1,Matches,495945ef
2837,Ben White,eng ENG,DF,Arsenal,eng Premier League,23,1997,32.0,44,23,30,8,6,28,45,62.2,17,42,24,18,42,86,102,0,Matches,35e413f1
2838,Silvan Widmer,ch SUI,DF,Mainz 05,de Bundesliga,28,1993,32.4,60,28,32,20,8,36,61,59.0,25,44,16,28,43,103,59,2,Matches,f68b64fc
2839,Georginio Wijnaldum,nl NED,MF,Paris S-G,fr Ligue 1,30,1990,18.4,15,9,2,12,1,11,19,57.9,8,13,3,10,9,24,7,0,Matches,eb58eef0
2840,Jetro Willems,nl NED,DF,Greuther Fürth,de Bundesliga,27,1994,17.8,30,15,18,10,2,15,26,57.7,11,15,3,12,14,44,42,0,Matches,9050ddc4
2841,Brandon Williams,eng ENG,DF,Norwich City,eng Premier League,20,2000,23.6,55,37,35,18,2,36,64,56.3,28,26,6,20,44,99,50,0,Matches,5e74d6c8
2842,Iñaki Williams,gh GHA,FW,Athletic Club,es La Liga,27,1994,30.9,14,5,1,6,7,5,17,29.4,12,18,3,15,3,17,20,0,Matches,6a99e0b1
2843,Neco Williams,wls WAL,DF,Liverpool,eng Premier League,20,2001,0.1,0,0,0,0,0,0,0,,0,0,0,0,0,0,0,0,Matches,dd323728
2844,Nico Williams,es ESP,MF,Athletic Club,es La Liga,19,2002,14.9,20,10,6,11,3,10,31,32.3,21,18,2,16,5,25,9,0,Matches,afdc14d7
2845,Joe Willock,eng ENG,MF,Newcastle Utd,eng Premier League,21,1999,22.6,64,37,30,28,6,29,68,42.6,39,37,6,31,21,85,10,1,Matches,a3b03921
2846,Callum Wilson,eng ENG,FW,Newcastle Utd,eng Premier League,29,1992,15.4,9,8,1,5,3,1,4,25.0,3,7,2,5,3,12,10,0,Matches,c596fcb0
2847,Patrick Wimmer,at AUT,MFFW,Arminia,de Bundesliga,20,2001,22.8,53,31,13,31,9,22,61,36.1,39,30,1,29,27,80,13,0,Matches,cb11b429
2848,Jonas Wind,dk DEN,FWMF,Wolfsburg,de Bundesliga,22,1999,13.1,10,6,1,7,2,1,4,25.0,3,8,3,5,6,16,13,0,Matches,2077ae86
2849,Marten Winkler,de GER,MF,Hertha BSC,de Bundesliga,18,2002,0.3,0,0,0,0,0,0,0,,0,0,0,0,0,0,0,0,Matches,e0d515ef
2850,Harry Winks,eng ENG,MF,Tottenham,eng Premier League,25,1996,10.1,15,10,4,9,2,8,21,38.1,13,14,3,11,16,31,10,2,Matches,2f7acede
2851,Frederik Winther,dk DEN,DF,Augsburg,de Bundesliga,20,2001,3.6,7,2,7,0,0,5,6,83.3,1,4,1,3,8,15,21,0,Matches,a1257b5e
2852,Florian Wirtz,de GER,MFFW,Leverkusen,de Bundesliga,18,2003,20.6,25,10,6,16,3,10,28,35.7,18,12,1,11,13,38,4,0,Matches,e7fcf289
2853,Yoane Wissa,cd COD,FW,Brentford,eng Premier League,24,1996,14.3,12,6,5,4,3,1,16,6.3,15,12,5,7,8,20,6,0,Matches,2500cef9
2854,Axel Witsel,be BEL,MFDF,Dortmund,de Bundesliga,32,1989,21.6,42,27,12,23,7,18,30,60.0,12,24,9,15,27,69,38,0,Matches,5dfc6ad5
2855,Hannes Wolf,at AUT,MF,M'Gladbach,de Bundesliga,22,1999,3.4,23,12,4,13,6,10,20,50.0,10,10,0,10,2,25,1,0,Matches,be42a291
2856,Marius Wolf,de GER,DFMF,Dortmund,de Bundesliga,26,1995,14.7,26,10,13,9,4,12,24,50.0,12,14,1,13,13,39,8,0,Matches,fa661778
2857,Luca Wollschläger,de GER,FWMF,Hertha BSC,de Bundesliga,18,2003,0.2,1,1,0,1,0,0,1,0.0,1,0,0,0,0,1,0,0,Matches,24b8e7bd
2858,Jeong Woo-yeong,kr KOR,FWMF,Freiburg,de Bundesliga,21,1999,19.8,15,9,6,7,2,5,15,33.3,10,8,1,7,7,22,11,0,Matches,6190474d
2859,Chris Wood,nz NZL,FW,Burnley,eng Premier League,29,1991,15.2,7,5,0,3,4,3,10,30.0,7,13,4,9,0,7,3,0,Matches,4e9a0555
2860,Chris Wood,nz NZL,FW,Newcastle Utd,eng Premier League,29,1991,14.7,2,0,1,1,0,1,2,50.0,1,5,2,3,2,4,9,0,Matches,4e9a0555
2861,Freddie Woodman,eng ENG,GK,Newcastle Utd,eng Premier League,24,1997,4.0,0,0,0,0,0,0,0,,0,0,0,0,0,0,0,1,Matches,19e50035
2862,Christopher Wooh,cm CMR,DF,Lens,fr Ligue 1,19,2001,11.7,29,11,20,8,1,11,18,61.1,7,21,14,7,21,50,40,1,Matches,b003239d
2863,Joscha Wosz,de GER,DF,RB Leipzig,de Bundesliga,19,2002,0.1,0,0,0,0,0,0,0,,0,0,0,0,0,0,0,0,Matches,80c9e555
2864,Xeka,pt POR,MF,Lille,fr Ligue 1,26,1994,18.0,47,27,18,24,5,27,56,48.2,29,23,3,20,24,71,26,1,Matches,f3600c02
2865,Granit Xhaka,ch SUI,MFDF,Arsenal,eng Premier League,28,1992,25.9,32,18,16,12,4,16,41,39.0,25,21,6,15,21,53,31,0,Matches,e61b8aee
2866,Sekou Yansané,gn GUI,FW,Paris S-G,fr Ligue 1,18,2003,0.2,0,0,0,0,0,0,1,0.0,1,0,0,0,0,0,1,0,Matches,bce37ac0
2867,Andriy Yarmolenko,ua UKR,MFFW,West Ham,eng Premier League,31,1989,3.5,4,2,2,2,0,2,8,25.0,6,4,2,2,0,4,2,0,Matches,849c826a
2868,Yusuf Yazıcı,tr TUR,MFFW,Lille,fr Ligue 1,24,1997,5.7,10,5,3,6,1,1,9,11.1,8,4,0,4,2,12,1,0,Matches,f5c8b425
2869,Kelvin Yeboah,it ITA,FWMF,Genoa,it Serie A,21,2000,9.4,14,7,5,7,2,9,19,47.4,10,22,1,21,1,15,7,0,Matches,ea0893d6
2870,Gerard Yepes,es ESP,MFDF,Sampdoria,it Serie A,18,2002,0.2,1,0,0,1,0,1,1,100.0,0,1,0,1,0,1,0,0,Matches,ee9040b4
2871,Burak Yılmaz,tr TUR,FW,Lille,fr Ligue 1,36,1985,24.6,7,2,0,2,5,2,17,11.8,15,8,1,7,2,9,11,0,Matches,165a2e40
2872,Okay Yokuşlu,tr TUR,DFMF,Getafe,es La Liga,27,1994,5.2,9,8,6,2,1,5,5,100.0,0,7,5,2,5,14,17,0,Matches,e49ce451
2873,Okay Yokuşlu,tr TUR,DFMF,Celta Vigo,es La Liga,27,1994,1.6,4,1,2,1,1,2,3,66.7,1,2,1,1,2,6,6,0,Matches,e49ce451
2874,Leny Yoro,fr FRA,MF,Lille,fr Ligue 1,15,2005,0.1,1,0,0,1,0,0,0,,0,1,0,1,0,1,0,0,Matches,6763f716
2875,Maya Yoshida,jp JPN,DF,Sampdoria,it Serie A,32,1988,20.3,17,10,8,9,0,8,15,53.3,7,27,20,7,28,45,72,1,Matches,caffaf5a
2876,Ashley Young,eng ENG,DFFW,Aston Villa,eng Premier League,36,1985,13.9,18,6,9,6,3,11,16,68.8,5,10,4,6,13,31,25,1,Matches,be927d03
2877,Nathan Young-Coombes,eng ENG,MF,Brentford,eng Premier League,18,2003,0.0,0,0,0,0,0,0,0,,0,0,0,0,0,0,0,0,Matches,f9682888
2878,Zaydou Youssouf,fr FRA,MF,Saint-Étienne,fr Ligue 1,22,1999,17.3,48,26,21,25,2,14,34,41.2,20,11,3,8,17,65,13,0,Matches,e2f9bb5f
2879,Mattia Zaccagni,it ITA,MF,Hellas Verona,it Serie A,26,1995,2.0,3,1,1,0,2,1,2,50.0,1,1,0,1,4,7,0,0,Matches,d85c238b
2880,Mattia Zaccagni,it ITA,FW,Lazio,it Serie A,26,1995,20.8,33,16,10,13,10,11,19,57.9,8,17,2,15,20,53,5,0,Matches,d85c238b
2881,Dan-Axel Zagadou,fr FRA,DF,Dortmund,de Bundesliga,22,1999,10.6,13,7,11,1,1,7,10,70.0,3,14,4,10,15,28,38,2,Matches,a4effc55
2882,Wilfried Zaha,ci CIV,FWMF,Crystal Palace,eng Premier League,28,1992,30.7,40,20,14,15,11,10,31,32.3,21,28,0,28,5,45,5,0,Matches,b2bc3b1f
2883,Denis Zakaria,ch SUI,MF,Juventus,it Serie A,24,1996,6.6,11,7,3,6,2,3,11,27.3,8,16,3,13,11,22,7,0,Matches,384d58d9
2884,Denis Zakaria,ch SUI,MFDF,M'Gladbach,de Bundesliga,24,1996,15.5,23,14,9,10,4,12,35,34.3,23,25,5,20,19,42,22,1,Matches,384d58d9
2885,Joseba Zaldúa,es ESP,DF,Real Sociedad,es La Liga,29,1992,13.0,31,22,20,8,3,16,22,72.7,6,14,4,10,13,44,35,0,Matches,5ca20b7a
2886,Nicola Zalewski,pl POL,DF,Roma,it Serie A,19,2002,8.8,32,19,17,11,4,21,35,60.0,14,18,1,17,16,48,4,0,Matches,45191c29
2887,Andre-Frank Zambo Anguissa,cm CMR,MF,Napoli,it Serie A,25,1995,21.4,50,26,24,17,9,25,51,49.0,26,31,5,26,24,74,33,1,Matches,6bb2c084
2888,Nicolò Zaniolo,it ITA,FWMF,Roma,it Serie A,22,1999,21.9,24,15,0,15,9,6,28,21.4,22,19,0,19,7,31,6,0,Matches,9907b1c8
2889,Alessandro Zanoli,it ITA,DF,Napoli,it Serie A,20,2000,5.1,10,7,6,3,1,3,5,60.0,2,2,1,1,4,14,16,0,Matches,3b12b11f
2890,Mattia Zanotti,it ITA,DF,Inter,it Serie A,18,2003,0.1,1,0,1,0,0,0,1,0.0,1,0,0,0,0,1,0,0,Matches,875d65d1
2891,Duván Zapata,co COL,FW,Atalanta,it Serie A,30,1991,19.1,6,2,0,4,2,4,8,50.0,4,8,1,7,3,9,5,0,Matches,d3de9af0
2892,Gabriele Zappa,it ITA,DF,Cagliari,it Serie A,21,1999,12.7,21,9,12,6,3,6,24,25.0,18,15,5,10,14,35,28,0,Matches,ca3db240
2893,Davide Zappacosta,it ITA,DF,Atalanta,it Serie A,29,1992,26.1,32,22,12,13,7,19,37,51.4,18,32,2,30,12,44,22,0,Matches,7fe90ccd
2894,Oier Zarraga,es ESP,MF,Athletic Club,es La Liga,22,1999,13.0,13,5,4,7,2,3,28,10.7,25,17,10,7,19,32,10,0,Matches,968a1c2f
2895,Simone Zaza,it ITA,FWDF,Torino,it Serie A,30,1991,1.4,2,2,1,1,0,1,1,100.0,0,3,0,3,0,2,3,0,Matches,9592289a
2896,Akim Zedadka,dz ALG,DF,Clermont Foot,fr Ligue 1,26,1995,37.1,72,44,34,29,9,37,71,52.1,34,32,8,24,58,130,48,0,Matches,0ff630d0
2897,Deyovaisio Zeefuik,nl NED,DFMF,Hertha BSC,de Bundesliga,23,1998,6.3,11,10,6,4,1,6,12,50.0,6,12,4,8,11,22,21,1,Matches,58a2e9f6
2898,Marvin Zeegelaar,nl NED,DF,Udinese,it Serie A,30,1990,7.1,15,11,6,8,1,5,14,35.7,9,12,4,8,12,27,22,1,Matches,8abd0c03
2899,Arber Zeneli,xk KVX,FW,Reims,fr Ligue 1,26,1995,4.5,1,0,0,0,1,1,5,20.0,4,0,0,0,1,2,1,0,Matches,095e4199
2900,Robin Zentner,de GER,GK,Mainz 05,de Bundesliga,26,1994,32.0,2,2,2,0,0,2,2,100.0,0,0,0,0,2,4,21,1,Matches,5c4bf6ba
2901,Andi Zeqiri,ch SUI,FWMF,Augsburg,de Bundesliga,22,1999,11.3,14,7,3,5,6,3,12,25.0,9,10,1,9,2,16,12,0,Matches,d01231f0
2902,Mehdi Zerkane,dz ALG,MFDF,Bordeaux,fr Ligue 1,22,1999,0.9,0,0,0,0,0,0,1,0.0,1,1,1,0,2,2,0,0,Matches,53f6306f
2903,Edon Zhegrova,xk KVX,MF,Lille,fr Ligue 1,22,1999,5.3,14,5,2,8,4,5,6,83.3,1,4,1,3,2,16,2,0,Matches,34a88e3e
2904,Luca Zidane,fr FRA,GK,Rayo Vallecano,es La Liga,23,1998,7.2,0,0,0,0,0,0,1,0.0,1,0,0,0,0,0,1,1,Matches,c818c4d9
2905,Piotr Zieliński,pl POL,MF,Napoli,it Serie A,27,1994,23.2,19,12,5,9,5,6,21,28.6,15,13,2,11,8,27,4,0,Matches,a5296e55
2906,David Zima,cz CZE,DF,Torino,it Serie A,20,2000,14.6,20,12,8,11,1,9,20,45.0,11,15,13,2,23,43,42,0,Matches,acf7e795
2907,Christoph Zimmermann,de GER,DF,Norwich City,eng Premier League,28,1993,1.7,6,3,5,1,0,3,4,75.0,1,0,0,0,1,7,4,0,Matches,2d5f03bf
2908,Oleksandr Zinchenko,ua UKR,DF,Manchester City,eng Premier League,24,1996,11.6,20,14,7,10,3,11,20,55.0,9,11,3,8,14,34,15,1,Matches,51cf8561
2909,Hakim Ziyech,ma MAR,MFFW,Chelsea,eng Premier League,28,1993,14.7,19,10,5,12,2,10,36,27.8,26,11,1,10,10,29,10,0,Matches,6622454d
2910,Jeroen Zoet,nl NED,GK,Spezia,it Serie A,30,1991,7.0,1,0,1,0,0,1,1,100.0,0,0,0,0,0,1,4,0,Matches,cc1a0c57
2911,Simon Zoller,de GER,FWMF,Bochum,de Bundesliga,30,1991,6.6,4,2,2,1,1,1,3,33.3,2,3,0,3,4,8,2,0,Matches,29f7cfd9
2912,Nadir Zortea,it ITA,DFMF,Salernitana,it Serie A,22,1999,15.7,21,15,9,7,5,11,19,57.9,8,14,2,12,7,28,33,0,Matches,82598b71
2913,Banhie Zoukrou,fr FRA,DF,Troyes,fr Ligue 1,18,2003,0.9,1,0,1,0,0,1,2,50.0,1,0,0,0,0,1,2,0,Matches,aefa3050
2914,Kurt Zouma,fr FRA,DF,West Ham,eng Premier League,26,1994,23.1,11,6,8,3,0,4,7,57.1,3,31,26,5,34,45,132,0,Matches,ce4246f5
2915,Petar Zovko,ba BIH,GK,Spezia,it Serie A,19,2002,0.3,0,0,0,0,0,0,0,,0,0,0,0,0,0,1,0,Matches,54f6afe3
2916,Igor Zubeldia,es ESP,DF,Real Sociedad,es La Liga,24,1997,18.3,20,10,12,8,0,12,18,66.7,6,16,6,10,27,47,53,0,Matches,5c7845f6
2917,Martín Zubimendi,es ESP,MF,Real Sociedad,es La Liga,22,1999,28.8,52,25,19,30,3,22,44,50.0,22,30,13,17,49,101,48,1,Matches,3ee0dd59
2918,Szymon Żurkowski,pl POL,MF,Empoli,it Serie A,23,1997,25.6,58,33,24,21,13,29,68,42.6,39,43,10,33,35,93,32,1,Matches,4e1d5e59
2919,Martin Ødegaard,no NOR,MFFW,Arsenal,eng Premier League,22,1998,30.9,49,21,6,24,19,22,61,36.1,39,18,1,17,11,60,11,1,Matches,79300479
2920,Milan Đurić,ba BIH,FW,Salernitana,it Serie A,31,1990,24.1,1,1,0,1,0,1,3,33.3,2,6,1,5,2,3,32,0,Matches,405f6586
2921,Filip Đuričić,rs SRB,MF,Sassuolo,it Serie A,29,1992,7.5,13,10,7,1,5,5,13,38.5,8,7,1,6,4,17,1,0,Matches,eccbe56a